distant	[ˈdistənt]	adj.	 远的；遥远的；疏远的；不亲近的	
treat	[tri:t]	n.	 款待，请客	
anywhere	[ˈeniˌweə(r)]	adv.	 无论哪里；（用于否定、疑问等）任何地方	
pattern	[ˈpætən]	v.	 仿制，模仿	
prevail	[priˈveil]	v.	 （over，against）取胜，占优势；流行，盛行	
occasion	[əˈkeiʒən]	n.	 场合，时节，时刻；时机，机会	
sip	[sip]	n.	 一小口的量	
grape	[ɡreip]	n.	 葡萄	
auditorium	[ˌɔ:diˈtɔ:riəm]	n.	 观众席，听众席；会堂，礼堂	
update	[ʌpˈdeit]	v.	 更新，使现代化	
drink	[driŋk]	n.	 饮料；喝酒	
ask	[ɑ:sk]	vt.	 问，询问；请求，要求；邀请，约请	
bracket	[ˈbrækit]	n.	 （方）括号	
coincidence	[kəuˈinsidəns]	n.	 巧合；同时发生，共同存在；符合，一致	
throw	[θrəu]	n.	 投掷（距离）	
supply	[səˈplai]	n.	 供应，供应量	
awful	[ˈɔ:ful]	adj.	 极度的，极坏的；威严的，可怕的	
swamp	[swɔmp]	vt.	 浸没；使…应接不暇	
hedge	[hedʒ]	v.	 用树篱围住	
much	[mʌtʃ]	adv.	 十分，非常；到极大程度	
disgrace	[disˈɡreis]	v.	 使失宠；玷辱，使蒙羞	
chess	[tʃes]	n.	 棋，国际象棋	
semester	[siˈmestə]	n.	 学期	
tape	[teip]	v.	 录音；系，捆	
blast	[blɑ:st]	v.	 爆炸	
eloquent	[ˈeləkwənt]	adj.	 雄辩的，有说服力的；善辩的，口才流利的	
velocity	[viˈlɔsiti]	n.	 速度，速率	
precedent	[ˈpresidənt]	n.	 先例	
intuition	[ˌɪntjuˈiʃən]	n.	 直觉	
hardware	[ˈhɑ:dwɛə]	n.	 五金，金属制品；硬件	
propaganda	[ˌprɒpəˈɡændə]	n.	 宣传（机构）；[天主教]传道总会	
eventually	[iˈventjuəli]	adv.	 终于，最后	
learn	[lə:n]	v.	 学习，学，学会；（of，about）听到，获悉	
scatter	[ˈskætə]	v.	 散开，驱散；散布，散播	
queer	[kwiə]	adj.	 奇怪的，古怪的	
layer	[ˈleiə]	n.	 层，层次；铺设者	
optional	[ˈɔpʃənl]	adj.	 可以任选的，随意的，非强制的	
depress	[diˈpres]	v.	 压抑，降低；使沮丧，压下	
resign	[rɪˈzaɪn]	v.	 辞去，辞职，使听从（于），使顺从	
finance	[faiˈnæns]	v.	 为…提供资金	
editorial	[ˌediˈtɔ:riəl]	adj.	 社论的；编辑上的	
direct	[diˈrekt]	v.	 管理，指导；（at，to）指向	
flat	[flæt]	n.	 一套房间；平面	
reveal	[riˈvi:l]	v.	 展现，显示，揭示，揭露，告诉，泄露	
angle	[ˈæŋɡl]	v.	 钓鱼；（采用各种方法）取得	
key	[ki:]	adj.	 主要的，关键的	
bend	[bend]	n.	 弯曲（处），曲折处	
duration	[djuəˈreiʃən]	n.	 持久；期间；持续时间	
machinery	[məˈʃi:nəri]	n.	 （总称）机器，机械	
easy	[ˈi:zi]	adj.	 容易的，不费力的，安逸的，宽裕的	
restrict	[risˈtrikt]	v.	 限制，约束	
herself	[hə:ˈself]	pron.	 [反身代词]她自己；她亲自，她本人	
disappear	[ˌdisəˈpiə]	v.	 不见，消失	
operator	[ˈɔpəreitə]	n.	 操作人员，（电话）接线员	
blush	[blʌʃ]	v.	 脸红	
resemble	[riˈzembl]	v.	 像，类似	
salute	[səˈlu:t]	v.	 敬礼，鸣礼炮；迎接，欢迎	
authority	[ɔ:ˈθɔriti]	n.	官方，当局）	
classic	[	adj.	 文豪； 文学名著； 优秀的典范； 古希腊与古罗马的文化研究（尤指对其语言与文学的研究） 	
pamphlet	[ˈpæmflit]	n.	 小册子	
influence	[	v.	 影响，感化	
whip	[hwip]	v.	 鞭打，抽打；突然移动	
proposal	[prəˈpəuzəl]	n.	 提议，建议；求婚	
trigger	[ˈtriɡə]	vt.	 触发，引起	
masterpiece	[ˈmɑ:stəpi:s]	n.	 杰作，名著	
rough	[rʌf]	adj.	 粗糙的；粗略的，大致的；粗野的，粗暴的	
everything	[ˈevriθiŋ]	pron.	 每件事，一切；最重要的东西	
lane	[lein]	n.	 小路，小巷，行车道	
drastic	[ˈdræstik]	adj.	 激烈的，严厉的；（药性等）猛烈的	
fabricate	[ˈfæbrikeit]	v.	 捏造，编造（谎言，借口等）；建造，制造	
dominant	[ˈdɔminənt]	adj.	 支配的，统治的，占优势的	
hysterical	[hisˈterikəl]	adj.	 情绪异常激动的，歇斯底里的	
recorder	[riˈkɔ:də]	n.	 记录员；录音机	
permit	[pəˈmit]	n.	 许可证，执照	
feeble	[ˈfi:bl]	adj.	 虚弱的，无力的	
accompany	[əˈkʌmpəni]	v.	 陪伴，陪同；伴随，和…一起发生，伴奏	
overpass	[ˈəuvəpɑ:s]	vt.	 胜过，通过，忽视	
temper	[ˈtempə]	vt.	 调和，使缓和；使回火	
gauge	[ɡeidʒ]	v.	 测量	
climate	[ˈklaimit]	n.	 气候；风气，社会思潮	
curious	[ˈkjuəriəs]	adj.	 好奇的，求知的，古怪的，爱挑剔的	
conference	[ˈkɔnfərəns]	n.	 （正式）会议；讨论，商谈	
solitary	[ˈsɔlitəri]	adj.	 孤独的；偏僻的；单一的，唯一的	
home	[həum]	adj.	 家庭的；家乡的	
assignment	[əˈsainmənt]	n.	 分配，指派；（指定的）作业，（分派的）任务	
any	[ˈeni]	adj.	 （用于否定句、疑问句等）什么，一些；任何的	
rice	[rais]	n.	 稻，米	
anyone	[ˈeniwʌn]	pron.	 （用于疑问句，否定式）任何人	
spirit	[ˈspirit]	n.	）情绪，心情；酒精	
recollect	[ˌrekəˈlekt]	v.	 回忆，想起，记起，忆起，记得	
formidable	[ˈfɔ:midəbl]	adj.	 强大的；令人敬畏的；可怕的；艰难的	
success	[səkˈses]	n.	 成就，成功；成功的事物，有成就的人	
guess	[ɡes]	v.	 猜测，推测；以为；猜想	
bruise	[bru:z]	vt.	 碰伤；擦伤；挫伤	
ambitious	[æmˈbiʃəs]	adj.	 有抱负的，雄心勃勃的；有野心的	
delete	[diˈli:t]	vt.	 删除	
conversation	[ˌkɔnvəˈseiʃən]	n.	 会话，谈话	
turkey	[ˈtɜːki]	n.	 火鸡（肉）	
child	[tʃaild]	n.	children）小孩，儿童，儿女	
character	[ˈkæriktə]	n.	 性格，品质，特性；人物，角色；字符，（汉）字	
flame	[fleim]	v.	 发火焰，燃烧	
electric	[iˈlektrik]	adj.	 电的，导电的，电动的	
mobilize	[ˈməubilaiz]	v.	 （mobilise）动员，赋予可动性	
difficulty	[ˈdifikəlti]	n.	 困难，困境，难题	
riot	[ˈraiət]	v.	 骚乱，暴动	
headline	[ˈhedlain]	n.	 大字标题，新闻标题	
tanker	[ˈtæŋkə]	n.	 油船	
convenient	[kənˈvi:njənt]	adj.	 （to）便利的，方便的	
entertain	[ˌentəˈtein]	v.	 招待，款待；使娱乐；使欢乐；容纳，接受	
store	[stɔ:]	v.	 贮藏，贮备	
torch	[tɔ:tʃ]	n.	 手电筒；火炬，火把	
closet	[ˈklɔzit]	vt.	 把…关在房间里；把…引进密室会谈	
successful	[səkˈsesful]	adj.	 圆满的；顺利的；成功的	
scar	[skɑ:]	v.	 使留下伤痕，创伤	
clever	[ˈklevə]	adj.	 聪明的，伶俐的，机敏的，精巧的	
straw	[strɔ:]	n.	 稻草，麦杆；吸管	
avenue	[ˈævinju:]	n.	 林荫路，大街；（比喻）途径，渠道，方法	
damage	[ˈdæmidʒ]	n.	 损害，损毁；赔偿金	
banquet	[ˈbæŋkwit]	vt.	 宴情	
veto	[ˈvi:təu]	n.	 否决	
contrary	[ˈkɔntrəri]	n.	 反对，矛盾；相反	
transient	[ˈtrænziənt]	adj.	 短暂的，转瞬即逝的；临时的，暂住的	
important	[imˈpɔ:tənt]	adj.	 重要的，重大的；有地位的，有权力的	
fork	[fɔ:k]	n.	 叉，耙；叉形物；餐叉	
coach	[kəutʃ]	vt.	 训练，指导，培训	
dome	[dəum]	n.	 圆屋顶	
afterward	[ˈæftəwəd]	adv.	 （afterwards）以后，后来	
reality	[riˈæliti]	n.	 现实，实际；真实	
crown	[kraun]	v.	 为…加冕	
depth	[depθ]	n.	 深，深度，深奥，深刻	
portrait	[ˈpɔ:trit]	n.	 肖像，画像	
goodness	[ˈɡudnis]	int.	良好； 善良； 精华； 上帝	
territory	[ˈteritəri]	n.	 领土；版图；领域，范围	
analysis	[əˈnæləsis]	n.	 analyses分析；分解	
peel	[pi:l]	n.	剥落	
reclaim	[riˈkleim]	v.	 要求归还，收回；开垦	
lash	[læʃ]	n.	 鞭子，鞭打，睫毛，讽刺	
concentrate	[ˈkɔnsəntreit]	n.	集中起来的，经过浓缩的	
lorry	[ˈlɔri]	n.	 卡车，运货汽车	
like	[laik]	n.	 象…一样	
residence	[ˈrezidəns]	n.	 住处，住宅	
inquiry	[inˈkwaiəri]	n.	 （enquiry）询问，打听，调查	
prime	[praim]	n.	 青春，全盛期	
ingredient	[inˈɡri:djənt]	n.	 （混合物的）组成部分，配料；成份，要素	
how	[hau]	adv.	 1。（表示方法、手段、状态）怎样；如何	
plentiful	[ˈplentiful]	adj.	 富裕的，丰富的	
concentration	[ˌkɔnsənˈtreiʃən]	n.	 专心，专注；集中，集结；浓度	
pronounce	[prəˈnauns]	v.	 发…的音；宣布，宣判	
figure	[ˈfiɡə]	v.	 描绘；计算；推测	
perhaps	[pəˈhæps]	adv.	 也许，大概，恐怕	
tourist	[ˈtuərist]	n.	 旅游者，观光客；巡回比赛的运动员	
inherent	[inˈhiərənt]	adj.	 内在的；固有的；生来就有的	
afternoon	[ˌɑ:ftəˈnu:n]	n.	 下午，午后	
distill	[diˈstil]	vt.	 蒸馏，用蒸馏法提取；吸取，提炼	
beloved	[biˈlʌvid]	adj.	 受爱戴的，敬爱的；爱人，被心爱的人	
shear	[ʃiə]	v.	 剪，修剪	
passer	[ˈpɑ:sə]	n.	 过路人	
inhale	[inˈheil]	v.	 吸入（气体等），吸（烟）	
quota	[ˈkwəutə]	n.	 （生产、进出口等的）配额，（移民的）限额	
pipe	[paip]	n.	 管子，导管；烟斗；笛	
communism	[ˈkɔmjunizəm]	n.	 共产主义	
spite	[spait]	n.	 恶意；怨恨	
net	[net]	n.	用网捕；	
ankle	[ˈæŋkl]	n.	 足踝，踝关节	
impetus	[ˈimpitəs]	n.	 推动（力），促进	
stranger	[ˈstreindʒə]	n.	 陌生人，生客；外地人，外国人	
pride	[praid]	v.	 使自豪	
fashion	[ˈfæʃən]	n.	 流行式样（或货品），风尚，风气；样子，方式	
hail	[heil]	n.	 雹	
sum	[sʌm]	v.	 合计，总计	
blind	[blaind]	n.	失明的	
sow	[səu]	v.	 播种	
import	[ˈimpɔ:t]	n.	 进口商品；要旨，含意	
wreck	[rek]	v.	 （船等）失事，遇难；破坏	
law	[lɔ:]	n.	 法律，法规，法学，规律，定律	
handful	[ˈhændful]	n.	 一把；少数；一小撮	
quarter	[ˈkwɔ:tə]	n.	）方向；住处	
want	[wɔnt]	n.	 需要；短缺	
heighten	[ˈhaitən]	v.	 提高，升高	
misunderstand	[ˌmisʌndəˈstænd]	v.	 误解，误会	
flu	[flu:]	n.	 （influenza）流行性感冒	
just	[dʒʌst]	adj.	 公正的，公平的	
successor	[səkˈsesə]	n.	 接替的人或事物，继任者	
today	[təˈdei]	n.	 今天；现在	
circular	[ˈsə:kjulə]	n.	圆形的； 环行的	
agreement	[əˈɡri:mənt]	n.	 协定，协议；契约；同意，一致	
energy	[ˈenədʒi]	n.	 活力，精力；能，能量	
celebrity	[siˈlebriti]	n.	 名人，名流；名声，名望	
stiff	[stif]	adj.	 硬的，僵直的；拘谨的；呆板的；艰难的	
slice	[slais]	n.	 切片；薄片；部分切（片）	
age	[eidʒ]	v.	 （使）变老	
patrol	[pəˈtrəul]	n.	 巡逻，巡查；巡逻队	
apple	[ˈæpl]	n.	 苹果，苹果树	
trumpet	[ˈtrʌmpit]	n.	 喇叭，小号	
van	[væn]	n.	 有篷汽车；有篷货运车厢	
would	[wud]	v.	 将；可能；将会；总是，总会；宁愿	
circuit	[ˈsə:kit]	n.	 环行，周线，巡回；电路，线路	
canteen	[kænˈti:n]	n.	 食堂；小卖部	
sell	[sel]	v.	 卖，出售	
induce	[inˈdju:s]	v.	 引诱，劝使；引起，导致；感应	
heat	[hi:t]	v.	 （给）加热，（使）变热	
study	[ˈstʌdi]	n.	 学习；研究	
carriage	[ˈkæridʒ]	n.	 （四轮）马车；（火车）客车厢	
corridor	[ˈkɔridɔ:]	n.	 走廊，通路	
rhythm	[ˈriðəm]	n.	 节奏，韵律	
dessert	[diˈzə:t]	n.	 正餐后的水果或甜食	
Thursday	[ˈθə:zdi]	n.	 星期四	
lapse	[læps]	v.	 失效，偏离，流逝	
catch	[kætʃ]	v.	 捕捉，捕获；赶上；感染；理解，听到	
sturdy	[ˈstə:di]	adj.	 坚定的，不屈不挠的；强健的，结实的	
symbol	[ˈsimbəl]	n.	 符号，标志；象征	
luggage	[ˈlʌɡidʒ]	n.	 行李，皮箱	
nutrition	[nju:ˈtriʃən]	n.	 营养，营养学	
Sunday	[ˈsʌndi]	n.	 星期日	
curtain	[ˈkə:tn]	n.	 窗帘，门帘；幕（布）	
caution	[ˈkɔ:ʃən]	vt.	 劝…小心	
consent	[kənˈsent]	v.	 （to）同意，赞成，答应	
chew	[tʃu:]	v.	 咀嚼；思量	
conscious	[ˈkɔnʃəs]	adj.	 （of）意识到的，自觉的；神志清醒的	
highlight	[ˈhailait]	n.	 最精彩的部分	
distinguish	[disˈtiŋɡwiʃ]	v.	 （from）区别，辨别；辨认出；使杰出	
dumb	[dʌm]	adj.	 哑的，无言的	
personnel	[ˌpə:səˈnel]	n.	 全体人员，全体职员；人事（部门）	
their	[ðer]	pron.	 [they的所有格]他（她、它）们的	
iron	[ˈaiən]	v.	 熨（衣），熨平	
fight	[fait]	v.	 打（仗），搏斗，斗争，战斗	
fatal	[ˈfeitəl]	adj.	 致命的，毁灭性的	
branch	[brɑ:ntʃ]	n.	 （树）条，分支；分店；（学科）分科，部门；支流	
motel	[məuˈtel]	n.	 （附有停车场的）汽车旅馆	
reliance	[riˈlaiəns]	n.	 信任，信心，依靠，依靠的人或物	
laundry	[ˈlɔ:ndri]	n.	 洗衣房（店）；待洗衣物，所洗衣物	
skim	[skim]	vi.	 轻轻掠过	
huge	[hju:dʒ]	adj.	 巨大的，庞大的	
giant	[ˈdʒaiənt]	adj.	 巨大的	
communication	[kəˌmju:niˈkeiʃən]	n.	 通讯，传达；通讯系统；交通（工具）	
valuable	[ˈvæljuəbl]	n.	 贵重物品，财宝	
refer	[riˈfə:]	v.	 参考，查询；提到，引用，涉及；提交，上呈	
swear	[swɛə]	v.	 （at）诅咒，骂人；宣誓，发誓	
glass	[ɡlɑ:s]	n.	）眼镜	
tram	[træm]	n.	 有轨电车	
calendar	[ˈkælində]	n.	 日历，月历	
subtle	[ˈsʌtl]	adj.	 精巧的，巧妙的；细微的，微妙的	
into	[ˈɪntuː]	prep.	 到…里面，进入；成为（表示变化）	
cafe	[ˈkæfeɪ]	n.	 咖啡馆，（小）餐馆	
fetch	[fetʃ]	n.	 取得；拿	
tramp	[træmp]	v.	 践踏；漂泊；步行	
invasion	[inˈveiʒən]	n.	 入侵，侵略	
friendship	[ˈfrendʃip]	n.	 友谊，友好	
flour	[ˈflauə]	n.	 面粉	
present	[ˈprezənt]	v.	 赠送，提出	
meet	[mi:t]	v.	 遇见；会谈；迎接；满足；符合	
volunteer	[ˌvɔlənˈtiə]	n.	 自愿（者，兵）；自愿（提供）	
sink	[siŋk]	n.	 水槽，水池	
notorious	[nəuˈtɔ:riəs]	adj.	 臭名昭著的，声名狼藉的	
bewilder	[biˈwildə]	v.	 使迷惑，难住	
glove	[ɡlʌv]	n.	 手套	
lateral	[ˈlætərəl]	adj.	 侧面的，旁边的	
gratitude	[ˈɡrætitju:d]	n.	 感激，感谢	
pop	[pɔp]	v.	 突然出现	
stare	[stɛə]	v.	 （at）盯，凝视	
surface	[ˈsə:fis]	adj.	 表面的，肤浅的	
towel	[ˈtauəl]	vt.	 用毛巾擦或擦干	
aunt	[ɑ:nt]	n.	 姨母，姑母，伯母，婶母，舅母，阿姨	
upstairs	[ˌʌpˈstɛəz]	adv.	 楼上的	
pregnant	[ˈpreɡnənt]	adj.	 怀孕的，孕育的，充满的，意味深长的	
technique	[tekˈni:k]	n.	 技巧，手艺，技能；技术，工艺	
chair	[tʃɛə]	vt.	 当…的主席，主持	
refusal	[riˈfju:zəl]	n.	 拒绝，回绝	
wisdom	[ˈwizdəm]	n.	 智慧，明智；名言，格言	
equator	[iˈkweitə]	n.	 赤道	
weary	[ˈwiəri]	v.	 使疲倦，使厌倦	
encourage	[inˈkʌridʒ]	v.	 鼓励，怂恿	
troop	[tru:p]	v.	 群集，集合	
hopeful	[ˈhəupful]	adj.	 给人希望的，抱有希望的	
lead	[li:d]	n.	 带领，引导；铅	
training	[ˈtreiniŋ]	n.	 训练，培养	
consolidate	[kənˈsɔlideit]	v.	 使加固，使加强；（把…）联为一体，合并	
tempt	[tempt]	v.	 诱惑，引诱；吸引，使感兴趣	
fantastic	[fænˈtæstik]	adj.	 （fantastical）奇异的，幻想的，异想天开的	
loss	[lɔs]	n.	 丧失，遗失；损失，损耗，亏损；失败	
decade	[ˈdekeid]	n.	 十年	
colonel	[ˈkə:nl]	n.	 （陆军）上校	
eastern	[ˈi:stən]	adj.	 东方的，东部的	
refresh	[riˈfreʃ]	v.	 （使）精神振作，（使）精力恢复	
drought	[draut]	n.	 旱灾，干旱	
canal	[kəˈnæl]	n.	 运河；（沟）渠	
slack	[slæk]	n.	）便裤	
fact	[fækt]	n.	 事实，实际	
shaft	[ʃɑ:ft]	n.	 轴；杆状物	
recommend	[ˌrekəˈmend]	v.	 推荐，介绍；劝告，建议	
frame	[freim]	v.	 设计；制定；给…加框；表达	
floor	[flɔ:]	n.	 地板，（楼房）的层	
acceptance	[əkˈseptəns]	n.	 接受，接收，验收，接纳；承认，认可	
norm	[nɔːm]	n.	 准则，规范，准则，平均数	
snake	[sneik]	n.	 蛇	
strife	[straif]	n.	 争吵；冲突，斗争；竞争	
altogether	[ˌɔ:ltəˈɡeðə]	adv.	 完全地，全部地；总共；总而言之	
weight	[weit]	n.	 重量；负荷；重要性，分量；砝码	
badge	[bædʒ]	n.	 徽章，像章；标记；象征；记号	
feast	[fi:st]	n.	 节日；宴会	
hell	[hel]	n.	 地狱，阴间；苦境，极大痛苦	
encounter	[inˈkauntə]	n.	 遇到，遭遇	
turbulent	[ˈtə:bjulənt]	adj.	 狂暴的，无秩序的	
apologise	[əˈpɔlədʒaiz]	v.	 （to，for）道歉，认错	
apparent	[əˈpærənt]	adj.	 表面的，貌似的；显然的，明明白白的	
some	[sʌm]	pron.	 一些	
district	[ˈdistrikt]	n.	 地区，行政区；美国各州的众议院选区	
tall	[tɔ:l]	adj.	 （身材）高大的；夸大的，离谱的	
consultant	[kənˈsʌltənt]	n.	 会诊医师，顾问医生；顾问	
maintain	[meinˈtein]	v.	 维修，保养，维持，供养，坚持，主张，支持	
peaceful	[ˈpi:sful]	adj.	 和平的，平静的，安宁的，爱好和平的	
climb	[klaim]	v.	 攀登，爬	
couple	[ˈkʌpl]	v.	 连接，结合	
establish	[isˈtæbliʃ]	v.	 建立，设立；安置，使定居	
dread	[dred]	v.	 恐惧，担心	
tooth	[tu:θ]	n.	teeth）牙齿；齿状物	
local	[ˈləukəl]	adj.	 地方的，当地的；局部的	
leadership	[ˈli:dəʃip]	n.	 领导	
unique	[ju:ˈni:k]	adj.	 唯一的，独一无二的	
knot	[nɔt]	v.	 打结	
hatred	[ˈheitrid]	n.	 憎恨，憎恶，怨恨	
together	[təˈɡeðə]	adv.	 共同，一起；合起来，集拢地	
pickup	[ˈpɪkˌʌp]	n.	 拾起，获得	
warrant	[ˈwɔrənt]	v.	 保证，担保	
youngster	[ˈjʌŋstə]	n.	 小伙子，年轻人；少年，儿童	
reserve	[riˈzə:v]	v.	 保留，储备；预定	
classical	[ˈklæsikəl]	adj.	 经典的，古典（文学）的	
nut	[nʌt]	n.	 坚果；螺母，螺帽	
drown	[draun]	v.	 溺死，淹没	
horizon	[həˈraɪzn]	n.	 地平线；眼界，见识	
conversely	[ˈkɒnvɜːsli]	adv.	 相反地	
ingenious	[inˈdʒi:njəs]	adj.	 巧妙的；制作精巧的；新颖独特的	
policy	[ˈpɔləsi]	n.	 政策，方针	
spend	[spend]	v.	 花费；消耗；度过，消磨	
final	[ˈfainəl]	n.	 结局；决赛；期末考试	
rubbish	[ˈrʌbiʃ]	n.	 垃圾，废物；废话	
numb	[nʌm]	v.	 使麻木	
act	[ækt]	n.	 行为，法令；一幕	
compile	[kəmˈpail]	vt.	 编辑，编制，搜集	
turnover	[ˈtə:nˌəuvə]	n.	 翻倒（物）；人员调整；（资金等）周转；营业额	
develop	[diˈveləp]	v.	 发展，开发，研制；显现，显影；发育，生长	
institute	[	v.	 设立，设置，制定	
suggest	[səˈdʒest]	v.	 建议，提出；使联想，使想起…；暗示	
weather	[ˈweðə]	n.	 天气，气象	
enterprise	[ˈentəpraiz]	n.	 事业，企（事）业单位；事业心，进取心	
then	[ðen]	adv.	 当时；然后，于是；那么，因而	
alarm	[əˈlɑ:m]	vt.	 惊动，惊吓；向…报警	
discharge	[disˈtʃɑ:dʒ]	v.	 卸货，排出；发射，放（电）；遣散，解雇	
deep	[di:p]	adv.	 深入地，深深地	
trunk	[trʌŋk]	n.	 皮箱；行李箱；树干，躯干	
brand	[brænd]	v.	 使铭记；打火印，打烙印	
affiliate	[əˈfilieit]	n.	 附属机构，分公司	
lack	[læk]	n.	 缺乏，不足	
percentage	[pəˈsentidʒ]	n.	 百分数，百分率，百分比	
pillar	[ˈpilə]	n.	 柱，台柱，栋梁	
influential	[ˌɪnfluˈenʃəl]	adj.	 有影响的；有权势的	
one	[wʌn]	pron.	 一个（只）（表示代替可数的东西）	
medical	[ˈmedikəl]	adj.	 医学的，医疗的，医药的；内科的	
municipal	[mjuˈnisipəl]	adj.	 市（立，政）的；地方性的，地方自治的	
posture	[ˈpɔstʃə]	v.	 作出某种姿势	
vegetation	[ˌvedʒiˈteiʃən]	n.	 植物，草木	
halt	[hɔ:lt]	v.	 止步，（使）停止	
basement	[ˈbeismənt]	n.	 地下室，地窖，建筑物的底部	
vary	[ˈvɛəri]	vt.	 改变，变化；使多样化	
protect	[prəˈtekt]	v.	 （from）保护，保卫	
brick	[brik]	v.	 用砖围砌，用砖填补	
chocolate	[ˈtʃɔkəlit]	n.	 巧克力（糖），巧克力色	
cough	[kɔf]	v.	 咳嗽	
prospective	[prəsˈpektiv]	adj.	 预期的	
wide	[waid]	adv.	 充分地，完全地；广泛地	
cooperative	[kəuˈɔpərətiv]	n.	 合作社	
replace	[riˈpleis]	vt.	 取代，替换，代替，把…放回原处	
cook	[kuk]	v.	 烹调，烧煮；纂改（账目），捏造	
underneath	[ˌʌndəˈni:θ]	adv.	 在下面，在底下	
Catholic	[ˈkæθəlɪk]	n.	 天主教徒	
opinion	[əˈpinjən]	n.	 意见，看法，主张	
fortunate	[ˈfɔ:tʃənit]	adj.	 幸运的，侥幸的	
fraction	[ˈfrækʃən]	n.	 碎片，小部分，一点儿；分数	
draft	[drɑ:ft]	v.	 起草，草拟	
indispensable	[ˌɪndisˈpensəbl]	adj.	 必不可少的；不可或缺的	
mankind	[mænˈkaind]	n.	 人类	
down	[daun]	adj.	 向下的	
ballot	[ˈbælət]	vi.	 投票	
psychiatry	[sɪˈkaɪətri:]	n.	 精神病学，精神病疗法	
wing	[wiŋ]	vt.	 为…装上翼，使…能飞；飞越	
tolerance	[ˈtɔlərəns]	n.	 宽容；容忍，忍受；耐药力；公差	
sweat	[swet]	v.	 （使）出汗	
manuscript	[ˈmænjuskript]	n.	 手稿，原稿	
broom	[bru:m]	n.	 扫帚；金雀花	
somewhere	[ˈsʌm(h)wɛə]	adv.	 某地，在某处；在附近，前后，大约	
advertise	[ˈædvətaiz]	vi.	 登广告	
owing	[ˈəuiŋ]	adj.	 欠的，未付的	
poke	[pəuk]	v.	 戳，刺，伸出，刺探，闲荡	
landlady	[ˈlændˌleɪdi:]	n.	 女房东，女地主	
rifle	[ˈraifl]	n.	 步枪	
mention	[ˈmenʃən]	v.	 提及，说起	
violence	[ˈvaiələns]	n.	 猛烈，强烈；暴力；强暴	
holder	[ˈhəuldə]	n.	 持有者，占有者；（台，架等）支持物	
lie	[lai]	n.	 谎话	
dazzle	[ˈdæzl]	n.	 耀眼的光	
folk	[fəuk]	adj.	 民间的	
capable	[ˈkeipəbl]	adj.	 有本领的，有能力的；（of）可以…的，能…的	
puppet	[ˈpʌpit]	n.	 木偶，傀儡	
reputation	[ˌrepjuˈteiʃən]	n.	 名誉，名声，声望	
his	[hiz]	pron.	 [he的所有格/物主代词]他的（所有物）	
speciality	[ˌspeʃiˈæliti]	n.	 （specialty）特性，性质；专业/长；特产	
wake	[weik]	v.	 醒来，唤醒；使觉醒，激发，引起	
wit	[wit]	n.	 智力，才智，智慧	
magnetic	[mæɡˈnetik]	adj.	 磁的，有磁性的；有吸引力的	
manage	[ˈmænidʒ]	v.	 经营，管理，处理；设法，对付；操纵，运用	
agree	[əˈɡri:]	vi.	 答应，赞同；适合，一致；商定，约定	
letter	[ˈletə]	n.	 信，函件；字母，文字	
heir	[ɛə]	n.	 继承人	
snap	[snæp]	v.	 呵斥；啪地移动；（使）突然断开，断开	
slow	[sləu]	v.	 （down）（使）放慢，减速	
survey	[ˈsɜrˌveɪ]	v.	 俯瞰，眺望；全面审视，调查；测量图，勘定	
keep	[ki:p]	v.	 保持，保存，遵守，经营，看守，拘留，维持	
incredible	[inˈkredəbl]	adj.	 不可相信的；妙极的；惹人喜爱的，了不起的	
spontaneous	[spɔnˈteiniəs]	adj.	 自发的，自然产生的	
cause	[kɔ:z]	v.	 使产生，引起	
journalist	[ˈdʒə:nəlist]	n.	 记者，新闻工作者	
ancient	[ˈeinʃənt]	adj.	 古代的，古老的，古式的	
six	[sɪks]	pron.	 六（个，只…）	
originate	[əˈridʒineit]	v.	 （in，from）起源，发生；首创，创造	
air	[eə(r)]	n.	 天空；气氛；空中；样子	
rural	[ˈruərəl]	adj.	 乡下的，田园的，乡村风味的	
ever	[ˈevə]	adv.	 曾经；永远；在任何时候；究竟	
subject	[ˈsʌbdʒikt]	v.	 使隶属	
simplify	[ˈsimplifai]	v.	 简化，使单纯	
inhabit	[inˈhæbit]	vt.	 居住于，存在于；栖息于	
civilian	[siˈviljən]	adj.	 平民的；民用的	
side	[said]	vi.	 支持	
exceptional	[ikˈsepʃənl]	adj.	 例外的，异常的；非凡的	
donate	[dəuˈneit]	vt.	 损赠（金钱等）；赠予	
demand	[diˈmɑ:nd]	v.	 要求，需要；请求；查问	
shuttle	[ˈʃʌtl]	v.	 往返穿梭	
bowling	[ˈbəuliŋ]	n.	 保龄球运动	
candy	[ˈkændi]	n.	 糖果	
messenger	[ˈmesindʒə]	n.	 送信者，使者，传令兵	
kidnap	[ˈkidnæp]	vt.	 诱拐；绑架，劫持	
jewel	[ˈdʒu:əl]	n.	 宝石；珍宝；珍贵的东西	
tub	[tʌb]	n.	 木盆，澡盆	
liquor	[ˈlikə]	n.	 酒；溶液，液剂	
flourish	[ˈflʌriʃ]	n.	 繁荣，茂盛，兴旺	
when	[hwen]	conj.	 那时；然后；而	
telegram	[ˈteliɡræm]	n.	 电报	
graze	[ɡreiz]	n.	 擦伤（处）	
spill	[spil]	n.	 摔下，跌下	
lace	[leis]	v.	 系带，扎带	
night	[nait]	n.	 夜间；夜；晚（上）	
repay	[ri:ˈpei]	v.	 偿还，报答	
grace	[ɡreis]	n.	 优美，文雅；恩惠，恩泽；宽限，缓刑；感恩祷告	
identical	[aiˈdentikəl]	adj.	 同一的，同样的	
independent	[ˌɪndiˈpendənt]	adj.	 （of）独立的，自主的	
spectacular	[spekˈtækjulə]	n.	 壮观的演出	
install	[inˈstɔ:l]	vt.	 （instal）安装，设置，安置；使就职，任命	
boot	[bu:t]	n.	 靴；（汽车后部的）行李箱；[the-]解雇	
dictate	[dikˈteit]	v.	 口授；（使）听写；指令，指示，命令	
despair	[disˈpɛə]	v.	 绝望	
anyway	[ˈeniwei]	adv.	 无论如何；到底；究竟；至少	
provision	[prəˈviʒən]	n.	）给养	
eject	[iˈdʒekt]	v.	 喷射，排出；驱逐	
resultant	[riˈzʌltənt]	adj.	 作为结果而发生的；合成的	
cafeteria	[ˌkæfiˈtiəriə]	n.	 自助食堂	
junior	[ˈdʒu:njə]	n.	 年少者；三年级学生	
fringe	[frindʒ]	vt.	 饰…的边；作为…的边缘，围绕着	
bore	[bɔ:]	n.	 讨厌的人，麻烦事	
brown	[braun]	n.	 褐色（的），棕色（的）	
slippery	[ˈslipəri]	adj.	 滑的，滑溜的	
research	[riˈsə:tʃ]	v.	 （into，on）研究，调查	
grief	[ɡri:f]	n.	 悲伤，悲痛；悲伤的事，悲痛的缘由	
dividend	[ˈdividend]	n.	 红利，股息；回报，效益；被除数	
chat	[tʃæt]	v.	 闲谈，聊天	
circumference	[səˈkʌmfərəns]	n.	 圆周，周围	
grope	[ɡrəup]	n.	 摸索，探索	
privacy	[ˈpraivəsi]	n.	 （不受干扰的）独处，自由，隐私；私生活	
troublesome	[ˈtrʌblsəm]	adj.	 令人烦恼的，讨厌的	
lunch	[lʌntʃ]	n.	 午餐，（美）便餐	
isle	[ail]	n.	 小岛（用于诗歌中）	
mislead	[ˌmisˈli:d]	v.	 把…带错路，使误入岐途	
physicist	[ˈfizisist]	n.	 物理学家	
onion	[ˈʌnjən]	n.	 洋葱	
plastic	[ˈplɑ:stik]	adj.	 可塑的，塑性的	
outstanding	[ˌautˈstændiŋ]	adj.	 突出的，显著的，杰出的	
cruise	[kru:z]	n.	 乘船巡游	
vein	[vein]	vt.	 使成脉络	
scale	[skeil]	n.	 刻度；天平，磅秤；比例尺；规模；音阶；鱼鳞	
circulate	[ˈsə:kjuleit]	v.	 （使）循环，（使）流通	
emphasis	[ˈemfəsis]	n.	 强调，重点	
spacious	[ˈspeiʃəs]	adj.	 广阔的，宽敞的	
do	[du:]	vi.	 行动	
what	[hwɔt]	adj.	 多么，何等；什么；尽可能多的	
militant	[ˈmilitənt]	n.	 斗士	
retort	[riˈtɔ:t]	n.	 报复，反击，反驳	
cycle	[ˈsaikl]	v.	 骑自行车；循环	
asleep	[əˈsli:p]	adj.	 睡觉，睡着（用作表语）	
bald	[bɔ:ld]	adj.	 秃的，秃头的	
mostly	[ˈməustli]	adv.	 几乎全部地；主要地，大部分，基本上	
weekend	[ˌwi:kˈend]	n.	 周末	
unanimous	[ju:ˈnæniməs]	adj.	 全体一致的，一致同意的	
approval	[əˈpru:vəl]	n.	 批准，通过；赞成，同意	
squeeze	[skwi:z]	n.	 榨取，勒索	
furniture	[ˈfə:nitʃə]	n.	 家具	
syndrome	[ˈsindrəum]	n.	 综合病征；并存特性	
before	[biˈfɔ:]	prep.	 （指时间）在…以前，在…前面，在…之前	
gigantic	[dʒaiˈɡæntik]	adj.	 巨大的，庞大的	
legal	[ˈli:ɡəl]	adj.	 法律的，法定的；合法的，正当的	
mask	[mɑ:sk]	v.	 掩饰，化装	
declare	[diˈklɛə]	v.	 宣布，宣告，声明；断言，宣称	
classification	[ˌklæsifiˈkeiʃən]	n.	 分类，分级	
housework	[ˈhauswə:k]	n.	 家务，家事（不可数）	
file	[fail]	v.	 锉；把（文件等）归档；提起（诉讼）；发送	
subordinate	[səˈbɔ:dinit]	adj.	 （to）次要的，从属的；下级的	
subscribe	[səbˈskraib]	vt.	 捐助，赞助	
bibliography	[ˌbibliˈɔɡrəfi]	n.	 （有关某一专题的）书目；参考书目	
lover	[ˈlʌvə]	n.	 爱好者；情侣	
lawyer	[ˈlɔ:jə]	n.	 律师	
publication	[ˌpʌbliˈkeiʃən]	n.	 出版物；出版，发行；公布，发表	
amid	[əˈmid]	prep.	 在…中间，在…之中，被…围绕	
commonplace	[ˈkɔmənpleis]	n.	 寻常的事物，平庸的东西	
stair	[stɛə]	n.	 楼梯	
robe	[rəub]	n.	 长袍，上衣	
outrage	[ˈautreidʒ]	v.	 凌辱，引起…义愤，强奸	
descendant	[diˈsendənt]	n.	 子孙，后代	
esteem	[isˈti:m]	vt.	 尊重，敬重；把…看作	
zigzag	[ˈziɡzæɡ]	v.	 使曲折，曲折盘旋	
swift	[swift]	n.	 迅速地，敏捷地	
mode	[məud]	n.	 方式，式样	
fold	[fəuld]	n.	 褶，褶痕；羊栏；信徒	
aviation	[ˌeivi:ˈeiʃən]	n.	 航空，航空学；飞机制造业	
spit	[spit]	n.	 唾液	
parasite	[ˈpærəsait]	n.	 寄生虫，食客	
bulletin	[ˈbulitin]	n.	 公报，公告，告示	
height	[hait]	n.	）高地，高处	
this	[ðis]	adv.	 这（样）	
shut	[ʃʌt]	v.	 关，关闭	
crisp	[krisp]	adj.	 脆的，易碎的；简明扼要的；清爽的	
underline	[ˌʌndəˈlain]	vt.	 在…下划线；强调	
medal	[ˈmedəl]	n.	 奖章，勋章，纪念章	
captive	[ˈkæptiv]	adj.	 被俘虏的，被监禁的	
ethnic	[ˈeθnik]	adj.	 种族的；少数民族的	
simplicity	[simˈplisiti]	n.	 简单；朴素；直率，单纯	
stitch	[stitʃ]	v.	 缝（合）	
vegetable	[ˈvedʒitəbl]	adj.	 植物的，蔬菜的	
opportunity	[ˌɔpəˈtju:niti]	n.	 机会	
style	[stail]	n.	 风格，文体；式样，时式，类型	
page	[peidʒ]	vt.	 给…标页码；呼叫	
greet	[ɡri:t]	v.	 致敬，敬意，迎接；扑（鼻），入（耳），触（目）	
narrative	[ˈnærətiv]	n.	 叙述	
butterfly	[ˈbʌtəflai]	n.	 蝴蝶	
underlying	[ˌʌndəˈlaiiŋ]	adj.	 含蓄的，潜在的；在下面的	
by	[bai]	adv.	 在近旁；经过	
pray	[prei]	v.	 请求，恳求；祈祷，祈求	
compromise	[ˈkɔmprəmaiz]	vt.	 危及，放弃（原则等）	
tag	[tæɡ]	vi.	 紧随	
reservation	[ˌrezəˈveiʃən]	n.	 保留，保留意见；预定，预订	
ward	[wɔ:d]	vt.	 挡住	
partner	[ˈpɑ:tnə]	n.	 合作者，合伙人，合股人，伙伴，舞伴，配偶	
melt	[melt]	v.	 （使）融化，（使）熔化	
whatever	[hwɔtˈevə]	adj.	 无论什么样的	
aesthetic	[i:sˈθetik]	adj.	 （esthetic）美学的，艺术的；审美的	
wool	[wul]	n.	 羊毛，毛线，毛织品	
intensity	[inˈtensiti]	n.	 强烈，剧烈；强度	
virus	[ˈvaiərəs]	n.	 病毒；（精神，道德方面的）有害影响	
deviate	[ˈdi:vieit]	v.	 （from）背离，偏离	
ornament	[ˈɔ:nəmənt]	n.	 装饰，装饰物	
elderly	[ˈeldəli]	n.	 [the-]到了晚年的人	
generalize	[ˈdʒenərəlaiz]	v.	 （generalise）归纳，概括；推广，普及	
mist	[mist]	n.	 薄雾，霭	
indoor	[ˈindɔ:]	adj.	 室内的，户内的	
scientist	[ˈsaiəntist]	n.	 科学家	
batch	[bætʃ]	n.	 一批，一组，一群	
hatch	[hætʃ]	n.	 舱口，小门	
target	[ˈtɑ:ɡit]	n.	 目标，对象，靶子	
scientific	[ˌsaiənˈtifik]	adj.	 科学上的	
reign	[rein]	n.	 统治；统治时期；支配；任期	
eight	[eɪt]	adj.	 八（个，只…）的	
instinct	[ˈinstiŋkt]	n.	 本能，直觉，天性	
weekly	[ˈwi:kli]	n.	 周刊，周报	
invent	[inˈvent]	v.	 发明，创造；捏造，虚构	
oval	[ˈəuvəl]	n.	 卵形，椭圆形	
elsewhere	[ˈelsˈhwɛə]	adv.	 在别处，向别处	
calm	[kɑ:m]	v.	 （使）平静	
adapt	[əˈdæpt]	vi.	 适应	
entail	[inˈteil]	vt.	 使承担；遗传给；限定	
boss	[bɔs]	vt.	 指挥，控制，发号施令	
hand	[hænd]	v.	 交，递，给	
reptile	[ˈreptail]	n.	 爬行动物	
dominate	[ˈdɔmineit]	v.	 支配，统治，控制；占优势	
furious	[ˈfjuəriəs]	adj.	 狂怒的，狂暴的，猛烈的	
principal	[ˈprinsəpəl]	n.	 负责人，校长；资本，本金	
plumber	[ˈplʌmə]	n.	 （装修水管的）管子工	
solid	[ˈsɔlid]	n.	 固体	
overnight	[ˌəuvəˈnait]	adv.	 在昨夜，一夜工夫，突然	
row	[rəu]	v.	 划（船等），荡桨	
bottle	[ˈbɔtl]	v.	 装瓶	
testify	[ˈtestɪfaɪ]	v.	 作证，证明；（to）表明，说明	
odd	[ɔd]	adj.	 奇数的；奇怪的；单只的；临时的；带零头的	
bathroom	[ˈbɑ:θrum]	n.	 浴室；盥洗室，卫生间	
seize	[si:z]	v.	 抓住，逮住；夺取，占领；没收，查封	
original	[əˈridʒinəl]	n.	 原物，原作，原文	
curb	[kə:b]	vt.	 制止，抑制	
loudspeaker	[ˈlaudˌspi:kə]	n.	 扬声器，扩音器	
interim	[ˈintərim]	n.	 过渡时期，暂定	
bird	[bə:d]	n.	 鸟，雀；女人；嘘声	
invest	[inˈvest]	vt.	 投资；投入（精力、时间等）	
plantation	[plænˈteiʃən]	n.	 种植园	
systematic	[ˌsistəˈmætik]	adj.	 （systematical）系统的，有组织的	
pretend	[priˈtend]	v.	 假装，假托，借口，（在演戏中）装扮	
free	[fri:]	vt.	 释放	
grind	[ɡraind]	v.	 磨（碎），碾（碎）	
curve	[kə:v]	v.	 弄弯，成曲形	
see	[si:]	vt.	 看见；会面；探望；知道，获悉；送行	
peer	[piə]	v.	 凝视，隐约出现	
minimize	[ˈminimaiz]	v.	 （minimize）使减少到最少，使降到最低	
gasp	[ɡɑ:sp]	v.	 喘息；气吁吁地说	
modify	[ˈmɔdifai]	v.	 更改，修改，修饰	
hypocrisy	[hiˈpɔkrəsi]	n.	 伪善，虚伪	
queen	[kwi:n]	n.	 女王，皇后，王后	
fat	[fæt]	n.	 脂肪，肥肉	
chap	[tʃæp]	n.	 小伙子	
piece	[pi:s]	v.	 （together）拼合，拼凑	
theirs	[ðɛəz]	pron.	 [they的物主代词]他（她、它）们的	
headquarters	[ˈhedˈkwɔ:təz]	n.	 司令部，指挥部；总部，总局	
designate	[ˈdeziɡneit]	v.	 指明，指出；任命，指派；把…定名为	
gang	[ɡæŋ]	n.	 一帮，一群，一伙	
preparation	[ˌprepəˈreiʃən]	n.	 准备，预备；制剂，制备品	
attention	[əˈtenʃən]	n.	 注意，注意力；立正；特别照顾；照料	
all	[ɔ:l]	pron.	 全部	
midst	[midst]	n.	 中间，当中	
premier	[ˈpremiə]	n.	 首相，总理	
acquisition	[ˌækwiˈziʃən]	n.	 取得，学到，养成（习惯）；获得的东西	
feedback	[ˈfi:dbæk]	n.	 反馈；反应；回复	
satellite	[ˈsætəlait]	n.	 卫星，人造卫星；附属物	
promising	[ˈprɔmisiŋ]	adj.	 有希望的，有前途的	
telephone	[ˈtelifəun]	v.	 打电话	
frighten	[ˈfraitən]	v.	 使惊恐	
travel	[ˈtrævəl]	v.	 旅行；行进，传播	
array	[əˈrei]	v.	 列阵；装扮；排列	
convict	[kənˈvikt]	v.	 囚犯	
prize	[praiz]	v.	 珍视，珍惜	
hole	[həul]	n.	 洞，孔	
committee	[kəˈmiti]	n.	 委员会，全体委员	
define	[diˈfain]	v.	 给…下定义；阐述；阐释；限定，规定	
always	[ˈɔ:lweiz]	adv.	 总是，无例外地；永远，始终	
electronic	[ilekˈtrɔnik]	adj.	 电子的	
soluble	[ˈsɔljubl]	adj.	 可溶的	
supplement	[ˈsʌpliment]	v.	 增刊，补充	
birthday	[ˈbə:θdei]	n.	 生日；（成方）纪念日	
flare	[flɛə]	v.	 闪耀，闪烁	
handkerchief	[ˈhæŋkətʃif]	n.	 手帕	
inward	[ˈinwəd]	adj.	 向内的；向中心的；内在的	
private	[ˈpraivit]	adj.	 私人的，个人的，秘密的，私下的	
dangerous	[ˈdeindʒərəs]	adj.	 危险的，不安全的	
dip	[dip]	v.	 浸，蘸	
silent	[ˈsailənt]	adj.	 寂静，沉默的	
accustomed	[əˈkʌstəmd]	adj.	 惯常的；习惯的，适应的（一般作表语）	
statue	[ˈstætju:]	n.	 塑像，雕像	
evolve	[iˈvɔlv]	v.	 （使）发展；（使）进化；（使）进展	
memo	[ˈmeməu]	n.	 （memorandum）备忘录	
and	[ænd]	conj.	 和，与，而且；那么；接连，又	
pour	[pɔ:]	v.	 灌注，倾泻，涌入，流，倾盆大雨	
fraud	[frɔ:d]	n.	 欺诈，诈骗；欺骗（行为）；骗子；假货	
assess	[əˈses]	vt.	 （为征税）评估（财产、收入）；征税；评价	
rumor	[ˈru:mə]	n.	 （rumour）传闻，谣言	
ownership	[ˈəunəʃip]	n.	 所有（权），所有制	
theft	[θeft]	n.	 偷窃，偷窃罪	
recipe	[ˈresəpi]	n.	 烹饪法，食谱；诀窍，方法	
however	[hauˈevə]	conj.	 无论	
palm	[pɑːm]	vt.	 与…握手，藏…于掌中；用手抚摩	
economical	[ˌɪkəˈnɔmikəl]	adj.	 节约的，经济的	
routine	[ru:ˈti:n]	adj.	 常规的，例行的	
skeptical	['skeptɪkəl]	adj.	 怀疑的	
liable	[ˈlaiəbl]	adj.	 有…倾向的；可能遭受…的；有责任的	
sensible	[ˈsensəbl]	adj.	 明智的，达理的；可觉察的，明显的	
ability	[əˈbiliti]	n.	 能力；本领；才能；天资	
wipe	[waip]	v.	 擦，揩，抹	
millionaire	[ˌmiljəˈnɛə]	n.	 百万富翁	
matter	[ˈmætə]	v.	 有关系，要紧	
module	[ˈmɔdju:l]	n.	 单元，组件，模块，模件；（航天器的）舱	
prosecute	[ˈprɔsikju:t]	vi.	 作检察官	
major	[ˈmeidʒə]	v.	 主修	
immigrant	[ˈimiɡrənt]	n.	 移民，侨民	
regular	[ˈreɡjulə]	adj.	 有规律的；整齐的，匀称的，正规的，正式的	
fuse	[fju:z]	v.	 熔化，熔合	
forest	[ˈfɔrist]	n.	 森林	
vocation	[vəʊˈkeɪʃən]	n.	 职业；召唤；天命；天职；才能	
anybody	[ˈeniˌbɔdi]	pron.	 （否定句）任何人；（肯定句）随便哪个人	
evoke	[iˈvəuk]	vt.	 唤起（回忆、感情等）；引起	
commute	[kəˈmju:t]	v.	 乘公交车上下班，乘车（船等）往返于两地	
argument	[ˈɑ:ɡju:mənt]	n.	 争论（吵），辩论；理由；论证	
sale	[seil]	n.	 出售，上市；贱卖，廉价出售；销售额	
edible	[ˈedibl]	adj.	 可食用的	
admit	[ədˈmit]	vt.	 承认，供认；准许…进入，准许…加入	
cheat	[tʃi:t]	n.	 骗子；欺诈，欺骗行为	
video	[ˈvidiəu]	adj.	 电视的，视频的；录像的	
endeavor	[enˈdevə]	v.	 （endeavour）努力，尽力，力图	
cassette	[kəˈset]	n.	 盒子；盒式磁带	
imaginary	[iˈmædʒinəri]	adj.	 想象的，虚构的	
daytime	[ˈdeɪˌtaɪm]	n.	 白天，日间	
aid	[eid]	v.	 援助，救援	
submarine	[ˈsʌbməri:n]	adj.	 水底的，海底的	
correct	[kəˈrekt]	v.	 改正，纠正，矫正	
meantime	[ˈmi:ntaim]	adv.	 同时，当时	
wet	[wet]	n.	 雨天；湿地	
bank	[bæŋk]	vi.	 （在某银行）开账户，存款；信赖	
care	[kɛə]	v.	 （about）关心，介意，计较；照顾	
accountant	[əˈkauntənt]	n.	 会计人员，会计师	
top	[tɔp]	adj.	 最高的；顶上的	
layoff	[ˈleɪ	n.	 临时解雇，操作停止，活动停止期间，失业期	
penalty	[ˈpenəlti]	n.	 处罚，刑罚，惩罚，罚金	
at	[æt]	prep.	 在（某地）；在…方面；在…旁边	
transplant	[trænsˈplɑ:nt]	n.	 移植（植物；组织，器官等）；迁移	
yard	[jɑ:d]	n.	 院子，场地；码	
smooth	[smu:ð]	v.	 （over）掩饰；抹；捋	
profession	[prəˈfeʃən]	n.	 职业，专业，表白，宣布	
print	[print]	v.	 印刷，出版；洗印	
confront	[kənˈfrʌnt]	v.	 使面临，使遭遇；面对（危险等）	
touch	[tʌtʃ]	n.	 触动，碰到；少许	
cyberspace	[ˈsaibəˌspeis]	n.	 虚拟信息空间；网络空间	
pathetic	[pəˈθetik]	adj.	 可怜的，悲惨的	
embed	[imˈbed]	vt.	 把…嵌（埋、插）入，扎牢；使深留脑中	
cucumber	[ˈkju:kʌmbə]	n.	 黄瓜	
cluster	[ˈklʌstə]	v.	 群集，丛生，（使）聚集	
express	[iksˈpres]	n.	 快车，快运	
valid	[ˈvælid]	adj.	 有效的；有根据的；正当的	
seven	[ˈsevən]	num.	 七，七个（人或物）	
civilization	[ˌsivilaiˈzeiʃən]	n.	 （civilisation）文明，文化	
entertainment	[ˌentəˈteinmənt]	n.	 招待，款待；表演文娱节目	
sheer	[ʃiə]	adj.	 纯粹的，十足的，全然的；陡峭的，险峻的	
somebody	[ˈsʌmbədi]	n.	 重要人物	
sad	[sæd]	adj.	 悲哀的，忧愁的	
humiliate	[hjuˈmilieit]	v.	 使羞辱，使丢脸[同]disgrace	
bloom	[blu:m]	v.	 开花	
leisure	[ˈleʒə]	n.	 空闲，闲暇；悠闲，安逸	
you	[ju:]	pron.	 你；你们；一个人，任何人	
directory	[diˈrektəri]	n.	 人名地址录，号码簿	
sacred	[ˈseikrid]	adj.	 神圣的；宗教的；庄严的	
creature	[ˈkri:tʃə]	n.	 人，动物；生物	
drift	[drift]	v.	 漂，漂流（物）	
publish	[ˈpʌbliʃ]	v.	 出版，刊印；公布，发布	
range	[reindʒ]	v.	 排列成行	
cricket	[ˈkrikit]	n.	 板球；蟋蟀	
monopoly	[məˈnɔpəli]	n.	 垄断，专卖，专利权，专利事业	
ruler	[ˈru:lə]	n.	 统治者，支配者；尺，直尺	
street	[stri:t]	n.	 街，街道；行车道	
ideal	[aiˈdiəl]	n.	 理想	
supermarket	[ˈsju:pəˌmɑ:kit]	n.	 超级市场	
elementary	[ˌeliˈmentəri]	adj.	 初步的；基本的；[化]元素的；自然力的	
fresh	[freʃ]	adj.	 新鲜的，无经验的	
compatible	[kəmˈpætəbl]	adj.	 能和睦相处的，合得来的；兼容的	
accessory	[ækˈsesəri]	n.	 附件，附属品；（衣服的）配饰	
segment	[ˈseɡmənt]	n.	 段，片，节，部分	
efficiency	[iˈfiʃənsi]	n.	 效率；功效	
decent	[ˈdi:sənt]	adj.	 体面的；正派的，合乎礼仪的；合适的	
hair	[hɛə]	n.	 毛发，头发；绒毛，毛状物	
obstruction	[əbˈstrʌkʃən]	n.	 妨碍，障碍物	
capital	[ˈkæpitl]	adj.	 主要的，大写字母的	
stage	[steidʒ]	n.	 舞台，戏剧；阶段，时期	
fourteen	[fɔː(r)ˈtiːn]	num.	 十四，十四个	
voluntary	[ˈvɔləntəri]	adj.	 自愿的，志愿的	
massacre	[ˈmæsəkə]	n.	 残杀，大屠杀	
pillow	[ˈpiləu]	n.	 枕头	
they	[ðei]	pron.	 他[她，它]们；大家；当局	
parade	[pəˈreid]	v.	 游行；（使）接受检阅；列队行进；炫耀	
hurl	[hə:l]	vt.	 猛投，力掷；大声叫骂	
portable	[ˈpɔ:təbl]	adj.	 轻便的，手提（式）的，可移动的	
symphony	[ˈsimfəni]	n.	 交响乐，交响曲	
court	[kɔ:t]	n.	 法院，法庭；宫廷，朝廷；院子；球场	
adventure	[ədˈventʃə]	vt.	 大胆进行	
metropolitan	[ˌmetrəˈpɔlitən]	adj.	 首都的，主要都市的，大城市	
transparent	[trænsˈpɛərənt]	adj.	 透明的，透光的；易理解的；明显的	
jewelry	[ˈdʒu:əlri:]	n.	 （总称）珠宝，首饰	
representative	[ˌrepriˈzentətiv]	adj.	 （of）典型的，有代表性的	
excitement	[ikˈsaitmənt]	n.	 刺激，激动，兴奋	
prisoner	[ˈprizənə]	n.	 囚犯	
afford	[əˈfɔ:d]	vt.	 担负得起，买得起；提供；给予	
sequence	[ˈsi:kwəns]	n.	 先后，次序；连续，数列	
oath	[əuθ]	n.	 誓言，誓约，诅咒	
true	[truː]	adj.	 真实的；忠实，可靠的；正确无误的	
thesis	[ˈθi:sis]	n.	theses）论文；论题；论点	
chain	[tʃein]	v.	 用链条拴住	
dissolve	[diˈzɔlv]	v.	 （使）溶解，（使）融化；解散，取消	
agitate	[ˈædʒiteit]	v.	 摇动（液体）；使焦虑不安；困扰；鼓动	
romance	[rəuˈmæns]	n.	 传奇，爱情故事	
legitimate	[liˈdʒitimit]	vt.	 使合法	
protein	[ˈprəuti:n]	n.	 蛋白质	
consecutive	[kənˈsekjutiv]	adj.	 连续的；连贯的；顺序的	
superb	[ˌsju:ˈpə:b]	adj.	 极好的，杰出的；华丽的	
sleep	[sli:p]	n.	 睡眠	
chemist	[ˈkemist]	n.	 化学家；药剂师	
operation	[ˌɔpəˈreiʃən]	n.	 运转，开动，操作，手术，运算，经营；行动	
trap	[træp]	vi.	 设圈套	
cream	[kri:m]	n.	 乳脂，（鲜）奶油；奶油色；护肤霜；药膏	
chemistry	[ˈkemistri]	n.	 化学	
interpret	[inˈtə:prit]	vt.	 解释；说明；阐释；口译	
band	[bænd]	v.	 缚，绑扎	
fell	[fel]	adj.	 凶猛的；可怕的	
understand	[ˌʌndəˈstænd]	v.	 懂，理解；获悉，听说；揣测，认为	
dislike	[disˈlaik]	n.	 不喜欢，厌恶	
mushroom	[ˈmʌʃrum]	vt.	 迅速生长，迅速增加，采蘑菇	
requirement	[riˈkwaiəmənt]	n.	 （for）需要，需要的东西，要求	
support	[səˈpɔ:t]	n.	 支撑；支持者	
attract	[əˈtrækt]	vt.	 引起注意（或兴趣等），吸引；引起；激起	
pose	[pəuz]	v.	 造成，提出，摆姿势，佯装	
genuine	[ˈdʒenjuin]	adj.	 真正的，名副其实的	
car	[kɑ:]	n.	 汽车，车辆，车；（火车）车厢	
nerve	[nə:v]	n.	 神经；勇敢，胆量	
disable	[disˈeibl]	vt.	 使残废；使失去能力；丧失能力	
require	[riˈkwaiə]	v.	 需要；（of）要求，命令	
royal	[ˈrɔiəl]	adj.	 王室的，皇家的；第一流的，高贵的；极大的	
fiction	[ˈfikʃən]	n.	 虚构，编造；小说	
fear	[fiə]	vt.	 畏惧，害怕，担心	
distance	[ˈdistəns]	n.	 距离，间隔，远方，路程	
peanut	[ˈpi:nʌt]	n.	 花生	
yours	[jɔ:z]	pron.	 [you的物主代词]你（们）的（所有物）	
console	[kənˈsəul]	vt.	 安慰，慰问	
oblige	[əˈblaidʒ]	v.	 强迫；责成；（使）感激，施恩于，帮…忙	
aboard	[əˈbɔ:d]	adv.	 上船（飞机），在船（或飞机、车）上	
disperse	[disˈpə:s]	v.	 （使）分散；（使）散开；疏散	
framework	[ˈfreimwə:k]	n.	 构架；框架；结构；组织；机构	
flatter	[ˈflætə]	vt.	 奉承；使高兴；胜过；自认为	
beneficial	[ˌbeniˈfiʃəl]	adj.	 （to）有利的，有益的	
biography	[baiˈɔɡrəfi]	n.	 传记；传记文学	
studio	[ˈstju:diəu]	n.	 画室；播音室；（电影）制片厂；单间公寓	
infer	[inˈfə:]	v.	 推论，推断	
intermittent	[ˌɪntəˈmitənt]	adj.	 间歇的，断断续续的	
diversion	[daiˈvə:ʃən]	n.	 转向，转移；牵制；解闷；娱乐	
sweet	[swi:t]	n.	 糖果；甜食	
soil	[sɔil]	v.	 弄脏，（使）变脏	
nominal	[ˈnɔminəl]	adj.	 名义上的；（金额，租金）微不足道的	
adverse	[ˈædvə:s]	adj.	 逆的，相反的；敌对的；不利的；有害的	
assault	[əˈsɔ:lt]	n.	 突然而猛烈的攻击	
drawback	[ˈdrɔ:bæk]	n.	 欠缺，缺点；退还的关税	
oak	[əuk]	adj.	 橡木的	
aural	[ˈɔ:rəl]	adj.	 听觉的，听力的	
assure	[əˈʃuə]	vt.	 使确信，使放心（of）；向…保证	
content	[ˈkɔntent]	adj.	 （with）满足的	
certain	[ˈsə:tn]	adj.	 某，某一，某些；（of）一定的，确信的，可靠的	
son	[sʌn]	n.	 儿子；孩子	
wound	[wu:nd]	v.	 伤，伤害	
scrape	[skreip]	n.	 刮，擦痕，刮擦声	
tomb	[tu:m]	n.	 坟，冢	
insight	[ˈinsait]	n.	 洞察力，深入了解	
somehow	[ˈsʌmhau]	adv.	 以某种方式，用某种方法；不知怎么地	
filter	[ˈfiltə]	n.	 滤器，滤纸	
pain	[pein]	vt.	 使痛苦	
subway	[ˈsʌbwei]	n.	 地铁；地下行人隧道	
prescribe	[priˈskraib]	v.	 指示，规定；处（方），开（药）	
across	[əˈkrɔs]	adv.	 横过，穿过	
somewhat	[ˈsʌmhwɔt]	pron.	 一点儿，几分	
qualify	[ˈkwɔlifai]	v.	 （使）具有资格，证明合格；限制，限定；修饰	
recover	[rɪˈkʌvə(r)]	v.	 收回；（from）恢复，痊愈；重新获得	
kin	[kɪn]	adj.	 亲属关系的，同类的	
elephant	[ˈelifənt]	n.	 象，大象	
strength	[streŋθ]	n.	 力，力量；实力；长处，优点；人力；兵力	
barbecue	[ˈbɑ:bikju:]	vt.	 炙烤（肉等）	
indignant	[inˈdiɡnənt]	adj.	 愤怒的；愤慨的	
lab	[læb]	n.	 （laboratory）实验室	
mischief	[ˈmistʃif]	n.	 损害，伤害，危害；恶作剧，胡闹；灾祸	
jacket	[ˈdʒækit]	n.	 短上衣，茄克衫	
abnormal	[æbˈnɔ:məl]	adj.	 反常的，不正常的，不规则的	
shell	[ʃel]	n.	 壳，贝壳；炮弹	
robot	[ˈrəubɔt]	n.	 机器人，自动机械	
fireplace	[ˈfaiəpleis]	n.	 壁炉	
resent	[riˈzent]	v.	 对…表示忿恨，怨恨	
number	[ˈnʌmbə]	v.	 共计，编号	
marginal	[ˈmɑ:dʒinəl]	adj.	 记在页边的，旁注的；（意识）边缘的	
smart	[smɑ:t]	v.	 剧痛，刺疼	
resemblance	[riˈzembləns]	n.	 相似，相似性[点，物]	
acrobat	[ˈækrəˌbæt]	n.	 特技演员，杂技演员	
gown	[ɡaun]	n.	 长袍，特殊场合穿的长服，女礼服	
diamond	[ˈdaiəmənd]	n.	 金钢石，钻石；菱形	
upper	[ˈʌpə]	adj.	 上面的；上部的，较高的	
tick	[tik]	v.	 滴答响；打勾号于	
web	[web]	n.	 网，蜘蛛网	
aircraft	[ˈɛəkrɑ:ft]	n.	 飞机，飞船，飞行器	
typist	[ˈtaipist]	n.	 打字员	
anxious	[ˈæŋkʃəs]	adj.	 焦虑的，担心的；急于（得到的），渴望的	
exaggerate	[iɡˈzædʒəreit]	v.	 夸大，夸张	
doorway	[ˈdɔ:ˌweɪ]	n.	 门口	
tense	[tens]	adj.	 绷紧的，紧张的	
union	[ˈju:njən]	n.	 联合，团结；联盟，联邦；协会，社团；和谐	
method	[ˈmeθəd]	n.	 方法，办法	
bowel	[ˈbauəl]	n.	 肠；内部，深处	
diligent	[ˈdilidʒənt]	adj.	 勤奋的，用功的	
consequently	[ˈkɔnsikwəntli]	adv.	 结果，因此，所以	
jump	[dʒʌmp]	v.	 跳跃，跳动，跳过；暴涨，猛增	
ripe	[raip]	adj.	 熟的，成熟的；（for）时机成熟的	
task	[tɑ:sk]	n.	 任务，作业，工作	
edit	[ˈedit]	v.	 编辑，校订	
abstract	[ˈæbstrækt]	vt.	 提取；摘录要点	
adjective	[ˈædʒiktiv]	adj.	 形容词的，用作形容词的	
tunnel	[ˈtʌnəl]	n.	 隧道，山洞	
computer	[kəmˈpju:tə]	n.	 计算机，电脑	
dimension	[diˈmenʃən]	n.	 尺寸，尺度；维（数），度（数），方面	
hazard	[ˈhæzəd]	v.	 冒险，拼命	
antique	[ænˈti:k]	n.	 有价值的古物，古董；古风	
advisable	[ədˈvaizəbl]	adj.	 可取的，适当的，明智的	
scold	[skəuld]	v.	 责骂，训斥	
plaster	[ˈplɑ:stə]	n.	 灰泥；熟石膏；膏药	
criticize	[ˈkritisaiz]	v.	 （criticise）批评，评论	
above	[əˈbʌv]	prep.	 在…之上，高于	
league	[li:ɡ]	n.	 同盟，联盟；联合会，社团	
copy	[ˈkɔpi]	vt.	 抄写；考试中抄袭	
correspondent	[ˌkɔrisˈpɔndənt]	n.	 记者，通讯员；通信者	
underestimate	[ˌʌndərˈestimeit]	vt.	 低估，看轻	
gain	[ɡein]	n.	 增进，增加；收益	
odds	[ɔdz]	n.	 不平等，差异；机会	
practically	[ˈpræktikəli]	adv.	 几乎，实际上，简直	
concession	[kənˈseʃən]	n.	 让步，妥协；特许（权）	
intrude	[inˈtru:d]	v.	 侵扰，打扰；闯入，侵入	
notebook	[ˈnəutbuk]	n.	 笔记本	
return	[riˈtə:n]	v.	 返回，回来；归还，送还；回答	
victory	[ˈviktəri]	n.	 胜利	
housewife	[ˈhauswaif]	n.	 家庭主妇	
raise	[reiz]	v.	 举起，提升；增加；饲养；引起；竖起；提出	
turn	[tə:n]	n.	 使转动； 旋转； 使改变方向； 使不适 	
knife	[naif]	v.	 用刀切，用匕首刺	
thrill	[θril]	v.	 激动；（使）毛骨悚然	
ounce	[auns]	n.	 盎司，英两；少量，一点点	
themselves	[ðəmˈselvz]	pron.	 他（她、它）们自己；他（她、它）们亲自	
from	[frɔm]	prep.	 从，自从；由于；离；根据，按；去除	
digest	[daiˈdʒest]	n.	 文摘，摘要	
criticism	[ˈkritisizəm]	n.	 评论性的文章，评论；批评，指责	
grow	[ɡrəu]	v.	 生长，成长；渐渐变成；栽培，种植；发展	
trace	[treis]	v.	 描绘；跟踪，追踪	
futile	[ˈfju:tail]	adj.	 无效的，无用的，无希望的	
millimeter	['mɪlɪˌmiːtə]	n.	 （millimetre）毫米	
abrupt	[əˈbrʌpt]	adj.	 突然的，出其不意的；粗鲁无礼的	
must	[mʌst]	n.	 必须做的事	
motive	[ˈməutiv]	adj.	 发动的，运动的	
tin	[tin]	vt.	 镀锡于	
eternal	[i:ˈtə:nl]	n.	 永久的，永恒的	
science	[ˈsaiəns]	n.	 科学；学科	
shelf	[ʃelf]	n.	 架子，搁板	
extreme	[iksˈtri:m]	n.	 极端；最大程度	
build	[bild]	vi.	 增大，增强	
dye	[dai]	v.	 染，染色	
point	[pɔint]	v.	 （at，to）指	
city	[ˈsiti]	n.	 城市；都市；市	
solve	[sɔlv]	v.	 解决，解答	
republican	[riˈpʌblikən]	adj.	 共和的	
isolate	[ˈaisəleit]	vt.	 隔离，孤立	
prince	[prins]	n.	 王子，亲王	
grass	[ɡrɑ:s]	n.	 草，草地	
orchard	[ˈɔ:tʃəd]	n.	 果园，果园里的全部果树，<美俚>棒球场	
restraint	[risˈtreint]	n.	 抑制，制止	
fist	[fist]	vt.	 用拳头打；紧握	
comfortable	[ˈkʌmfətəbl]	adj.	 舒适的，舒服的；感到舒适的，安逸的	
tangle	[ˈtæŋɡl]	v.	 （使）缠绕；变乱	
philosophy	[fiˈlɔsəfi]	n.	 哲学，哲理，人生观，价值观，世界观	
grieve	[ɡri:v]	v.	 使悲伤，使伤心	
opt	[ɔpt]	vi.	 抉择，选择	
companion	[kəmˈpænjən]	n.	 同伴，共事者；伴侣	
thereafter	[ðɛərˈɑ:ftə]	adv.	 此后，以后	
porcelain	[ˈpɔ:slin]	adj.	 精制的，瓷器的	
warn	[wɔ:n]	vi.	 发出警告	
void	[vɔid]	adj.	 空虚的；没有的；无效的	
prompt	[prɔmpt]	v.	 激起，促进，推动	
thorough	[ˈθʌrə]	adj.	 彻底的，完全的；精心的	
awake	[əˈweik]	vi.	 醒来，醒悟到	
base	[beis]	v.	 （on）把…基于	
over	[ˈəuvə]	adj.	 结束的；过去的；外面的	
sympathize	[ˈsimpəθaiz]	v.	 （with）同情；共鸣，同感；赞成	
counsel	[ˈkaunsəl]	n.	 劝告，忠告；法律顾问，辩护人	
oppose	[əˈpəuz]	v.	 反对，使对立，使对抗，使相对	
superior	[sjuˈpiəriə]	n.	 上级；长者；高手	
distinct	[disˈtiŋkt]	adj.	 清楚的，明显的；（from）截然不同的	
ditch	[ditʃ]	n.	 沟，沟渠，水沟	
skate	[skeit]	n.	 冰鞋	
forecast	[ˈfɔ:-kɑ:st]	v.	 预测，预报	
whole	[həul]	adj.	 全体的；全部的；完整的；无缺的	
attribute	[əˈtribju:t]	v.	 属性，品质，特征	
gold	[ɡəuld]	adj.	 金的，金制的	
oven	[ˈʌvən]	n.	 炉，灶，灶箱	
stern	[stɜːn]	n.	 船尾，舟尾	
nuclear	[ˈnju:kliə]	adj.	 核心的，中心的；原子核的，核能的	
foundation	[faunˈdeiʃən]	n.	 基础，根本，建立，创立；地基，基金，基金会	
romantic	[rəuˈmæntik]	adj.	 浪漫的，传奇式的；不切实际的，好幻想的	
compel	[kəmˈpel]	v.	 强迫，迫使	
title	[ˈtaitl]	n.	 书名，标题；头衔，称号	
drive	[draiv]	n.	 驾驶	
fan	[fæn]	v.	 扇；煽动；激起	
previous	[ˈpri:viəs]	adj.	 先前的，以前的	
low	[ləu]	adj.	 低，矮；低级的，下层的，卑贱的；低声的	
deficit	[ˈdefisit]	n.	 赤字，逆差；亏损，亏空；不足，缺乏	
culture	[ˈkʌltʃə]	n.	 文化，文明；修养；耕种；栽培，培育	
wait	[weit]	n.	 等候，等待时间	
accident	[ˈæksidənt]	n.	 意外遭遇，事故；意外（因素）	
specialist	[ˈspeʃəlist]	n.	 专家	
wage	[weidʒ]	vt.	 进行，开展	
hum	[hʌm]	n.	 嗡嗡声，嘈杂声	
marry	[ˈmæri]	v.	 结婚，嫁，娶	
mouse	[maus]	n.	mice）鼠，耗子	
diet	[ˈdaiət]	n.	 饮食，食物	
disc	[disk]	n.	 （disk）圆盘，圆面，盘状物	
suck	[sʌk]	v.	 吸，舐；吸收（取）	
fault	[fɔ:lt]	n.	 过失，过错；缺点，毛病	
interact	[ˌɪntərˈækt]	v.	 互相作用，互相影响	
man	[mæn]	n.	 人；人类；男人	
confirm	[kənˈfə:m]	v.	 使更坚固，使更坚定；（进一步）证实；确认	
static	[ˈstætik]	adj.	 （statical）静态的，静力的	
intimate	[ˈɪntɪmət]	n.	 至交；密友	
neglect	[niˈɡlekt]	v.	 忽视；疏忽，漏做，忽略	
lesson	[ˈlesən]	n.	 （功）课；课程；教训	
compass	[ˈkʌmpəs]	n.	 罗盘，指南针；圆规	
late	[leit]	adv.	 晚，迟到；后期地；最近地	
script	[skript]	n.	 剧本（原稿）；手稿；笔迹，手迹	
kill	[kil]	vt.	 杀死，消灭；破坏，毁灭；消磨（时间）	
bias	[ˈbaiəs]	n.	 （使有）偏见，偏心，偏袒	
surplus	[ˈsə:pləs]	adj.	 过剩的，剩余的	
blanket	[ˈblæŋkit]	vt.	 铺上一层；覆盖，掩盖；用毯覆盖	
naval	[ˈneivəl]	n.	 海军的，军舰的	
sense	[sens]	v.	 觉得，意识到	
chancellor	[ˈtʃɑ:nsələ]	n.	 （英）大臣；法官；（德、奥）总理；大学校长	
quantitative	[ˈkwɔntitətiv]	adj.	 数量的，定量的	
country	[ˈkʌntri]	n.	 国家；农村，乡下	
fascinate	[ˈfæsineit]	v.	 迷住，强烈吸引	
homework	[ˈhəumwə:k]	n.	 （学生的）家庭作业、课外人员	
luxury	[ˈlʌkʃəri]	adj.	 奢华的，豪华的	
erase	[iˈreiz]	v.	 擦掉；删去；消磁	
shady	[ˈʃeɪdi:]	adj.	 成荫的，多荫的；可疑的，靠不住的	
complicated	[ˈkɔmplikeitid]	adj.	 错综复杂的，麻烦的，难解的	
woman	[ˈwumən]	n.	 women妇女，成年女子	
plug	[plʌɡ]	v.	 堵，塞，插上，插栓	
reward	[riˈwɔ:d]	v.	 （for）酬劳；酬谢	
humanity	[hju:ˈmæniti]	n.	 人类，人性，人情；人文科学	
as	[æz]	prep.	 作为	
worry	[ˈwʌri]	n.	 烦恼，焦虑	
wheel	[hwi:l]	n.	 轮，车轮	
thirty	[ˈθɜ:ti:]	num.	 三十，三十个（人或物）	
hawk	[hɔ:k]	n.	 鹰，隼	
flower	[ˈflauə]	vi.	 开花	
four	[fɔ:]	pron.	 四（个，只…）	
assimilate	[əˈsimileit]	vi.	 被吸收；被同化	
astronomy	[əsˈtrɔnəmi]	n.	 天文学	
hundred	[ˈhʌndrəd]	adj.	 一百的；许多	
consideration	[kənˌsidəˈreiʃən]	n.	 需要考虑的事，理由；考虑，思考；体谅，照顾	
kid	[kid]	v.	 戏弄，取笑	
friction	[ˈfrikʃən]	n.	 摩擦，摩擦力；矛盾，争执	
analogy	[əˈnælədʒi]	n.	 类似，相似，类比，类推	
fundamental	[ˌfʌndəˈmentəl]	n.	 基本原则，基本原理	
hen	[hen]	n.	 母鸡	
celebrate	[ˈselibreit]	vi.	 庆祝，过节	
gene	[dʒi:n]	n.	 基因	
panel	[ˈpænəl]	n.	 面，板；控制板，仪表盘；专门小组	
yes	[jes]	adv.	 是[用于肯定句前]，是的	
beauty	[ˈbju:ti]	n.	 美，美丽；美人，美丽的事物	
burglar	[ˈbə:ɡlə]	n.	 （入室行窃的）盗贼	
alternative	[ɔ:lˈtə:nətiv]	adj.	 非正统的，不寻常的；两者择一的	
opponent	[əˈpəunənt]	adj.	 对立的，对抗的	
neighbor	[ˈneibə]	n.	 （neighbour）邻居	
blow	[bləu]	n.	 打，打击	
skeleton	[ˈskelitn]	n.	 骨骼；骨架，框架；梗概，提要	
approve	[əˈpru:v]	v.	 （of）赞成，同意；批准，审议，通过	
hamburger	[ˈhæmbə:ɡə]	n.	 汉堡包，牛肉饼	
massive	[ˈmæsiv]	adj.	 厚实的，粗大的；大规模的，大量的	
kind	[kaind]	n.	 种类	
organism	[ˈɔ:ɡənizəm]	n.	 生物，有机体	
embark	[imˈbɑ:k]	v.	 （使）上船（或飞机，汽车等）；着手，从事	
fragment	[ˈfræɡmənt]	n.	 碎片，小部分，片断	
even	[ˈi:vən]	adj.	 均匀的；平的；相等的；偶数的	
distort	[disˈtɔ:t]	v.	 弄歪（嘴脸等）；扭曲；歪曲（真理、事实等）	
distract	[disˈtrækt]	v.	 分散；使分心；打扰；使心情烦乱	
distinction	[disˈtiŋkʃən]	n.	 区别，差别；级别；特性；声望；显赫	
scream	[skri:m]	v.	 尖声叫，喊叫着说出，（风）呼啸	
cell	[sel]	n.	 细胞；小房间；蜂房；电池	
signature	[ˈsiɡnitʃə]	n.	 签名，署名，签字	
structure	[ˈstrʌktʃə]	v.	 构造，建造	
sign	[sain]	v.	 签名（于），署名（于）	
greedy	[ˈɡri:di]	adj.	 贪吃的，贪婪的，渴望的	
sarcastic	[sɑ:ˈkæstik]	adj.	 讽刺的	
discourse	[ˈdiskɔ:s]	vi.	 讲述，著述	
extent	[iksˈtent]	n.	 广度，宽度，长度；程度，限度	
dark	[dɑ:k]	n.	 无光，黑暗	
provided	[prəˈvaidid]	conj.	 倘若，只要，假如	
recite	[riˈsait]	v.	 背诵，朗诵	
slide	[slaid]	n.	 滑坡，滑道；滑动；幻灯片	
trivial	[ˈtriviəl]	adj.	 琐碎的；无足轻重的	
dam	[dæm]	n.	 水坝，水闸	
waiter	[ˈweitə]	n.	 侍者，服务员	
verify	[ˈverifai]	vt.	 证实，查证；证明	
ashamed	[əˈʃeimd]	adj.	 惭愧的，羞耻的，害臊的	
lot	[lɔt]	n.	 许多，大量；签，抽签；命运；场地	
breach	[bri:tʃ]	vt.	 冲破，攻破	
fade	[feid]	n.	 淡入（出）；乏味（平淡）的	
glimpse	[ɡlimps]	n.	 一瞥，瞥见	
repetition	[ˌrepiˈtiʃən]	n.	 重复，反复	
transform	[trænsˈfɔ:m]	vt.	 改变，变换；变压；转化；改造，改造	
separate	[	adj.	 （from）分离的，分开的	
join	[dʒɔin]	v.	 参加，加入；联合，连接；和…在一起	
nineteen	[naɪnˈti:n]	pron.	 十九（个，只…）	
shortage	[ˈʃɔ:tidʒ]	n.	 不足，缺少	
atmosphere	[ˈætməsfiə]	n.	 大气（层）；空气；气氛，环境；大气压	
oppress	[əˈpres]	v.	 压迫，压制	
chalk	[tʃɔ:k]	n.	 粉笔，白垩	
recede	[riˈsi:d]	v.	 退回，后退；收回，撤回；跌落，缩减，贬值	
April	[ˈeiprəl]	n.	 四月	
fellow	[ˈfeləu]	adj.	 同样的，同事的	
unit	[ˈju:nit]	n.	 单位，单元；部件；装置	
sugar	[ˈʃuɡə]	vt.	 加糖于	
hardship	[ˈhɑ:dʃip]	n.	 艰难，困苦	
waist	[weist]	n.	 腰，腰部	
democratic	[ˌdeməˈkrætik]	adj.	 民主的	
hold	[həuld]	n.	 握住；船舱	
host	[həust]	n.	 主人；旅店老板；节目主持人；一大群，许多	
uniform	[ˈju:nifɔ:m]	adj.	 相同的，一律的	
dream	[dri:m]	n.	 梦，梦想，幻想	
wear	[wɛə]	n.	 穿，戴；磨损	
naked	[ˈneikid]	adj.	 裸体的，无遮蔽的，无掩饰的	
prestige	[presˈti:ʒ]	n.	 声望，威望，威信	
clean	[kli:n]	v.	 除去…污垢，把…弄干净	
assistance	[əˈsistəns]	n.	 协作；援助；帮助	
necessity	[niˈsesiti]	n.	 必要性，需要；必然性；必需品	
reduction	[riˈdʌkʃən]	n.	 减小，减少，缩小	
preach	[pri:tʃ]	v.	 宣讲（教义），布道；竭力鼓吹，宣传；说教	
yellow	[ˈjeləu]	n.	 黄色	
oxide	[ˈɔksaid]	n.	 [化]氧化物	
educate	[ˈedju:keit]	v.	 教育，培养，训练	
tease	[ti:z]	n.	 （爱）戏弄他人者；戏弄	
why	[hwai]	int.	 咳，哎呀	
liability	[ˌlaiəˈbiliti]	n.	 责任，义务；债务	
tidy	[ˈtaidi]	v.	 整理，收拾	
microscope	[ˈmaikrəskəup]	n.	 显微镜	
genetic	[dʒiˈnetik]	n.	 [-s]遗传学	
Negro	[ˈniːɡrəʊ]	adj.	 黑人的	
confuse	[kənˈfju:z]	v.	 使混乱，混淆	
nevertheless	[ˌnevəðəˈles]	adv.	 仍然，不过	
stimulate	[ˈstimjuleit]	v.	 刺激，使兴奋；激励，鼓舞	
joke	[dʒəuk]	v.	 说笑话，开玩笑	
two	[tu:]	n.	 两个（人或物）	
librarian	[laiˈbrɛəriən]	n.	 图书管理员	
sociable	[ˈsəuʃəbl]	adj.	 好交际的，友好的，合群的	
apt	[æpt]	adj.	 恰当的，适当的；易于…的，有…倾向的	
race	[reis]	v.	 赛跑	
breath	[breθ]	n.	 呼吸，气息	
clarify	[ˈklærifai]	v.	 澄清，阐明	
sister	[ˈsistə]	n.	 姐，妹；护士长；修女	
revolve	[riˈvɔlv]	v.	 （使）旋转；考虑；【天】公转，循环	
five	[faɪv]	pron.	 五（个，只…）	
pulse	[pʌls]	n.	 脉搏，脉冲	
initiate	[iˈniʃieit]	vt.	 开始，创始，发动；启蒙，使入门；引入	
galaxy	[ˈɡæləksi]	n.	 星系；（theGalaxy）银河（系）；一群显赫的人	
occupy	[ˈɔkjupai]	v.	 占，占用；占据，占领；使忙碌，使从事	
switch	[switʃ]	v.	 转变，转换；抽打	
plan	[plæn]	v.	 计划	
queue	[kju:]	v.	 （up）排队，排队等待	
complicate	[ˈkɔmplɪˌkeɪt]	v.	 使…复杂；使…难懂；使（疾病等）恶化	
certificate	[səˈtifikeit]	n.	 证（明）书，执照	
agony	[ˈæɡəni]	n.	 （精神或肉体的）极大痛苦，创伤	
earn	[ə:n]	v.	 赚得，挣得，获得	
clergy	[ˈklə:dʒi]	n.	 [总称]牧师，神职人员	
gulf	[ɡʌlf]	n.	 海湾	
freedom	[ˈfri:dəm]	n.	 自由，自主，免除，特权	
conversion	[kənˈvə:ʃən]	n.	 转变，转换；信仰的改变	
detail	[ˈdi:teil]	v.	 详述	
bolt	[bəult]	v.	 闩（门），关窗，拴住	
onto	[ˈɔntu]	prep.	 在…上面；到…上面	
trademark	[ˈtreidmɑ:k]	vt.	 注册的…商标	
resistance	[riˈzistəns]	n.	 （to）抵抗，反抗；抵抗力，阻力；电阻	
subtract	[səbˈtrækt]	v.	 减（去）	
no	[nəʊ]	n.	 不，拒绝	
section	[	n.	 章节，部分；地区，部门，科；截面	
brisk	[brisk]	adj.	 轻快的；生气勃勃的；兴隆的	
relay	[ˈriːleɪ]	n.	 接替人员，替班	
arrival	[əˈraivəl]	n.	 到达，到来；到达者，到达物	
piston	[ˈpistən]	n.	 活塞	
administration	[	n.	 经营，管理；行政，行政机关，管理部门	
paradigm	[ˈpærəˌdaɪm]	n.	 典范；范例；示例	
prudent	[ˈpru:dnt]	adj.	 谨慎的，智慧的，稳健的，节俭的	
far	[fɑ:]	adv.	 久远地；遥远地；到…程度，…得多	
sunshine	[ˈsʌnʃain]	n.	 日光，日照；晴天	
glow	[ɡləu]	n.	 白热，炽热；色彩鲜艳	
royalty	[ˈrɔiəlti]	n.	 皇家，皇族	
relish	[ˈreliʃ]	v.	 喜欢，品味	
genius	[ˈdʒi:njəs]	n.	 天才	
around	[əˈraund]	prep.	 在…四周（或附近）	
sick	[sik]	adj.	 有病的，患病的；恶心的，想吐的	
roast	[rəust]	v.	 烤，炙，烘	
wedding	[ˈwediŋ]	n.	 婚礼	
invention	[inˈvenʃən]	n.	 发明，创造；发明物	
due	[dju:]	adj.	 （to）应支付的；（车，船等）预定应到达的	
bold	[bəuld]	adj.	 大胆的，勇敢的；冒失的；黑体的，粗体的	
fatigue	[fəˈti:ɡ]	n.	 （使）疲劳	
witch	[witʃ]	n.	 女巫，巫婆，巫师	
member	[ˈmembə]	n.	 成员，会员	
dilute	[daiˈlju:t]	adj.	 稀释的，冲淡的	
exclaim	[iksˈkleim]	v.	 呼喊，惊叫，大声说	
grey	[ɡrei]	n.	 （gray）灰色（的）	
punctual	[ˈpʌŋktʃuəl]	adj.	 严守时刻的，准时的，正点的	
disaster	[diˈzɑ:stə]	n.	 灾难，大祸；彻底的失败	
taste	[teist]	n.	 滋味；味觉	
spare	[spɛə]	v.	 节约，节省；抽出（时间）	
introduction	[ˌɪntrəˈdʌkʃən]	n.	 介绍；导言，导论；众所周知	
unfortunately	[ʌnˈfɔːtʃənətli]	adv.	 不幸地	
triangle	[ˈtraiæŋɡl]	n.	 三角（形）	
southeast	[ˌsauθˈi:st]	n.	 东南（的），东南部（的）	
denounce	[diˈnauns]	vt.	 公开指责，公然抨击；谴责	
contest	[kənˈtest]	n.	 竞争，比赛，争论	
east	[iːst]	adj.	 东方的，东部的	
wire	[ˈwaiə]	v.	 发电报（给），给…装金属线	
old	[əuld]	adj.	 年老的；…岁的；长时间的，老的；过去的	
simulate	[ˈsimjuleit]	v.	 模仿，模拟；假装，冒充	
magic	[ˈmædʒik]	adj.	 有魔力的，魔术的	
tedious	[ˈti:diəs]	adj.	 乏味的，单调的，冗长的	
transmit	[trænzˈmit]	vi.	 发射信号；发报	
milk	[milk]	v.	 挤奶	
liquid	[ˈlikwid]	adj.	 液体的，液态的；流动的	
continual	[kənˈtinjuəl]	adj.	 不断的，连续的，频繁的	
ant	[ænt]	n.	 蚁；蚂蚁	
incident	[	n.	 事件；事故	
lens	[lenz]	n.	 透镜，镜头	
whatsoever	[ˌhwɔtsəʊˈevə]	adv.	 （用于否定句中以加强语气）任何	
station	[ˈsteiʃən]	v.	 安置，驻扎	
memory	[ˈmeməri]	n.	 记忆，记忆力；回忆；存储（器）	
dismiss	[disˈmis]	v.	 免职，解雇，开除，解散	
helmet	[ˈhelmit]	n.	 头盔，钢盔	
spokesman	[ˈspəuksmən]	n.	 发言人	
correspond	[ˌkɔrisˈpɔnd]	v.	 通信，（with）符合，一致；（to）相当于，对应	
courtesy	[ˈkə:tisi]	n.	 谦恭有礼；有礼貌的举止（或言词）	
economic	[ˌɪkəˈnɔmik]	adj.	 经济（上）的，经济学的	
occasional	[əˈkeiʒənəl]	adj.	 偶然的，非经常的，特殊场合的；临时的	
rare	[rɛə]	adj.	 稀有的，难得的，珍奇的；稀薄的，稀疏的	
drain	[drein]	v.	 排去，放干	
garden	[ˈɡɑ:dn]	n.	 （菜，花）园；公园	
reinforce	[ˌri:ɪnˈfɔ:s]	v.	 增援，加强	
steep	[sti:p]	vt.	 浸泡，沉浸	
goose	[ɡu:s]	n.	geese）鹅，雌鹅，鹅肉	
strengthen	[ˈstreŋθn]	v.	 加强，巩固	
spray	[sprei]	v.	 喷，喷射	
offer	[ˈɔfə]	n.	 出价，提议，意图	
increasingly	[ɪnˈkriːsɪŋli]	adv.	 不断增加地，日益	
diverse	[daiˈvəs]	adj.	 多种多样的，（from）不同的	
successive	[səkˈsesiv]	adj.	 接连的，连续的	
poor	[puə]	adj.	 贫困的；可怜的；贫乏的；贫瘠的；低劣的	
attach	[əˈtætʃ]	v.	 系，贴，装，连接；使依恋；从属	
another	[əˈnʌðər]	pron.	 另一个，再一个	
crime	[kraɪm]	n.	 罪行，犯罪	
pension	[ˈpenʃən]	n.	 养老金，年金	
favor	[ˈfeivə]	v.	 赞成，支持，偏爱	
king	[kiŋ]	n.	 君主，国王	
curriculum	[kəˈrikjuləm]	n.	 课程，（学校等的）全部课程	
intention	[inˈtenʃən]	n.	 意图，意向，目的	
bang	[bæŋ]	v.	 砰地关上，猛撞，猛击	
headache	[ˈhedeik]	n.	 头痛	
against	[əˈɡenst]	prep.	 反对；对着，逆；违反；紧靠着；对比	
recreation	[ˌrekriˈeiʃn]	n.	 娱乐，消遣	
overtime	[ˈəʊvəˌtaɪm]	adv.	 加班	
foreigner	[ˈfɔrinə]	n.	 外国人	
fitting	[ˈfitiŋ]	n.	 配件，附件；装配	
eighteen	[eɪˈti:n]	num.	 十八，十八个	
slope	[sləup]	v.	 （使）倾斜	
assemble	[əˈsembl]	vi.	 集合，聚集	
tenant	[ˈtenənt]	vt.	 租借，承租	
cancel	[ˈkænsəl]	v.	 取消，把…作废；删去，划掉	
thorn	[θɔ:n]	n.	 刺，荆棘	
expense	[iksˈpens]	n.	 花费，消费，消耗	
furnace	[ˈfə:nis]	n.	 炉子，熔炉	
paddle	[ˈpædl]	v.	 用桨划	
tree	[tri:]	vi.	 爬上树	
expansion	[iksˈpænʃən]	n.	 扩张，膨胀；张开，伸展	
settle	[ˈsetl]	v.	 安定，安顿；停息；定居；解决，调停	
locker	[ˈlɔkə]	n.	 更衣箱，寄物柜	
pair	[pɛə]	v.	 配对，成对	
safeguard	[ˈseifɡɑ:d]	n.	 安全装置，安全措施	
gear	[ɡiə]	v.	 （to）调整，使适合；使为…而准备	
rise	[raiz]	n.	 上涨，增高；起源	
phone	[fəun]	v.	 打电话	
madame	[məˈdæm]	n.	 （madam）夫人，太太，女士	
emerge	[iˈmə:dʒ]	vt.	 显现，浮现；暴露；形成	
remarkable	[riˈmɑ:kəbl]	adj.	 值得注意的；显著的，异常的，非凡的	
popular	[ˈpɔpjulə]	adj.	 流行的，通俗的，大众的；广受欢迎的	
engage	[ɪnˈɡeɪdʒ]	v.	 （in）从事，着手；约定；使订婚；保证；雇用	
awkward	[ˈɔ:kwəd]	adj.	 笨拙的；尴尬的；使用不便的；难处理的	
fracture	[ˈfræktʃə]	v.	 （使）断裂，（使）折断	
pay	[pei]	n.	 工资，薪金	
package	[ˈpækidʒ]	n.	 包装，包裹，箱，包装费，标准部件，成套设备	
minimum	[ˈminiməm]	adj.	 最小的，最低的	
augment	[ɔ:ɡˈment]	vt.	 （使）增大，增加，增长，扩张	
preface	[ˈprefis]	v.	 作序，写前言	
thoughtful	[ˈθɔ:tful]	adj.	 认真思考的，沉思的；体贴的，关心的	
explore	[ɪkˈsplɔː(r)]	v.	 勘探，探测；探究，探索	
contradict	[ˌkɔntrəˈdikt]	v.	 反驳；同…矛盾，同…抵触	
immense	[iˈmens]	adj.	 广大的，巨大的；[口]极好的	
merit	[ˈmerit]	v.	 值得，应得	
spoil	[spɔil]	v.	 损坏，搞错；宠坏，溺爱	
pile	[pail]	v.	 （up）堆，叠，堆积	
perish	[ˈperiʃ]	v.	 丧生；凋谢；毁灭，消亡	
tap	[tæp]	vt.	 开发	
peasant	[ˈpezənt]	n.	 （不用于英国或美国）小农；佃农；农民	
retain	[riˈtein]	v.	 保持，保留	
interval	[ˈintəvəl]	n.	 间隔，间歇；（幕间或工间）休息	
represent	[ˌrepriˈzent]	v.	 描述，表示；代表，代理；阐明，说明	
graphic	[ˈɡræfik]	adj.	 绘画似的，图解的，生动的	
remains	[riˈmeins]	n.	 剩余，残余，遗迹	
predict	[priˈdikt]	v.	 预言，预测，预告	
delight	[diˈlait]	v.	 （使）高兴，（使）欣喜	
idle	[ˈaidl]	v.	 空费，虚度	
impressive	[imˈpresiv]	adj.	 给人深刻印象的，感人的	
receive	[riˈsi:v]	v.	 收到，接到；遭受，受到；接待，接见	
lest	[lest]	conj.	 惟恐，免得	
sofa	[ˈsəufə]	n.	 长沙发，沙发	
heap	[hi:p]	v.	 （up）堆，堆起	
diplomatic	[ˌdipləˈmætik]	adj.	 外交的，从事外交的；策略的，有手腕的	
torment	[ˈtɔ:ment]	vt.	 折磨；纠缠	
bit	[bit]	n.	 一点，一些；小块，少量；片刻；[计]位，比特	
senior	[ˈsi:njə]	n.	 （大学）四年级学生	
holiday	[ˈhɔlədi]	n.	 假日，节日，假期，休假	
hungry	[ˈhʌŋɡri]	adj.	 饥饿的，渴望的	
doom	[du:m]	v.	 注定，命定	
go	[ɡəu]	n.	 围棋	
fleet	[fli:t]	n.	 舰队，船队	
synthesis	[ˈsinθisis]	n.	 综合，合成	
reel	[ri:l]	v.	 卷，绕	
ultimate	[ˈʌltimit]	adj.	 最后的，最终的；根本的	
loom	[lu:m]	v.	 隐现，（危险、忧虑等）迫近	
refugee	[ˌrefjuˈdʒi:]	n.	 （政治上的）避难者，难民	
organ	[ˈɔ:ɡən]	n.	 器官；机构，机关；风琴	
ribbon	[ˈribən]	n.	 缎带，丝带，带，带状物	
meaning	[ˈmi:niŋ]	n.	 意思，意义，含义；重要性，价值	
moon	[mu:n]	n.	 （加the）月球，月亮；卫星	
charm	[tʃɑ:m]	v.	 迷人，（使）陶醉；施魔法于	
rotary	[ˈrəutəri]	adj.	 旋转的	
rob	[rɔb]	v.	 （of）抢劫，盗取；非法剥夺	
scratch	[skrætʃ]	n.	 抓，搔，抓痕；起跑线	
lay	[lei]	v.	 放，搁；下（蛋）；铺设；设置，布置	
interest	[ˈintrist]	v.	 （in）使发生兴趣	
farm	[fɑ:m]	v.	 种田，经营农牧业	
accuracy	[ˈækjurəsi]	n.	 准确（性）；精确；准确度	
luck	[lʌk]	n.	 运气；好运，侥幸	
everywhere	[ˈevrihwɛə]	adv.	 到处，各处，无论何处	
confidential	[ˌkɔnfiˈdenʃəl]	adj.	 秘（机）密的；表示信任的；担任机密工作的	
bed	[bed]	n.	 床，床位；（苗）床，坛；河床，（湖、海的）底	
breathe	[bri:ð]	v.	 呼吸，吸入，生存；小憩一会儿，歇歇气	
response	[riˈspɔns]	n.	 回答，响应，反应	
bill	[bil]	n.	 账单；招贴，广告；（人员，职称等的）表；钞票	
overlap	[ˌəuvəˈlæp]	n.	 重叠	
march	[mɑ:tʃ]	n.	 行军，行程	
origin	[ˈɔridʒin]	n.	 起源，由来；出身，来历	
soak	[səuk]	v.	 浸泡，浸湿，浸透	
worldwide	[ˈwə:ldwaid]	adv.	 遍及全世界	
rain	[rein]	vt.	 使大量落下	
invalid	[inˈvælid]	adj.	 有病的，伤残的；无效的	
sane	[sein]	adj.	 心智健全的，神志清醒的，明智的，稳健的	
imply	[imˈplai]	v.	 意指，含…意思，暗示	
shield	[ʃi:ld]	v.	 保护，防护	
suspicious	[səˈspiʃəs]	adj.	 （of）可疑的，多疑的，疑心的	
trail	[treil]	v.	 追踪，跟踪；拖，拖曳	
cap	[kæp]	v.	 覆盖于…顶端	
perspective	[pəˈspektiv]	n.	 透视画法，透视图；远景，前途；观点，看法	
boil	[bɔil]	v.	 （使）沸腾，煮（沸）	
modest	[ˈmɔdist]	adj.	 谦虚的，有节制的	
second	[ˈsekənd]	v.	 赞成，附和	
power	[ˈpauə]	n.	 力，精力；功率，电力；（数学）幂；权力，势力	
consume	[kənˈsju:m]	vt.	 消耗；吃完，喝光；（with）使着迷；烧毁	
share	[ʃɛə]	n.	 一份，份额；股份	
spectator	[spekˈteitə]	n.	 观众，旁观者	
choose	[tʃu:z]	v.	 选择，挑选；甘愿	
complaint	[kəmˈpleint]	n.	 抱怨，诉苦，怨言，控告；疾病	
flesh	[fleʃ]	n.	 肉，肌肉	
dish	[diʃ]	n.	 碟子，盘子，菜肴	
evidence	[ˈevidəns]	n.	 明显；显著；根据；证据；迹象	
certainty	[ˈsə:tnti]	n.	 必然，肯定；必然的事	
moisture	[ˈmɔistʃə]	n.	 潮湿，湿气，湿度	
exceedingly	[ikˈsi:diŋli]	adv.	 极端地，非常	
excellent	[ˈeksələnt]	adj.	 卓越的，极好的	
limit	[ˈlimit]	v.	 （to）限制，限定	
shrewd	[ʃru:d]	adj.	 机灵的，敏锐的；精明的	
liberty	[ˈlibəti]	n.	 自由，自由权；特权	
swan	[swɔn]	vi.	 闲荡，游荡	
there	[ðɛə]	adv.	 在那儿；往那儿	
ready	[ˈredi]	adj.	 （for）准备好的，现成的；甘心的	
jug	[dʒʌɡ]	n.	 （有柄，小口，可盛水等的）大壶，罐，盂	
sportsman	[ˈspɔ:tsmən]	n.	 爱好运动的人；运动员	
cave	[keiv]	n.	 洞，穴	
data	[ˈdeitə]	n.	 （datum的复数）资料，数据	
secret	[ˈsiːkrət]	n.	 秘密	
excel	[ikˈsel]	vt.	 胜过，优于	
toy	[tɔi]	vi.	 （with）漫不经心地考虑；摆弄	
garment	[ˈɡɑ:mənt]	n.	 衣服	
dairy	[ˈdɛəri]	n.	 牛奶场，奶店	
dwell	[dwel]	v.	 住，居留	
sing	[siŋ]	v.	 唱，演唱；鸡叫	
currency	[ˈkʌrənsi]	n.	 流传，流通；通货，货币	
mountain	[ˈmauntin]	n.	 山	
strap	[stræp]	v.	 用带扣住，束牢；用绷带包扎	
generous	[ˈdʒenərəs]	adj.	 宽宏大量的，慷慨的	
sand	[sænd]	n.	 沙；沙滩，沙地	
paint	[peint]	v.	 油漆；涂，涂漆；画；描绘，描述	
enclose	[inˈkləuz]	v.	 围住，圈起，封入，附入	
recovery	[riˈkʌvəri]	n.	 痊愈，复元；重获，收回	
bureaucracy	[bjuəˈrɔkrəsi]	n.	 官僚主义，官僚机构；（非民选的）委任官员	
negative	[ˈneɡətiv]	n.	 负数；（摄影）底片	
speaker	[ˈspi:kə]	n.	 说话者，发言者；说某种语言者；扬声器	
persecute	[ˈpə:sikju:t]	v.	 迫害	
bump	[bʌmp]	n.	 碰撞	
whose	[hu:z]	pron.	 谁的；哪（个）人的，那些（人）的	
fore	[fɔː(r)]	n.	 前部	
exchange	[iksˈtʃeindʒ]	v.	 （for）交换，兑换；交流，交易；交换台	
favorable	[ˈfeɪvərəbəl]	adj.	 （favourable）赞许的，有利的，讨人喜欢的	
concert	[ˈkɔnsət]	n.	 音乐会，演奏会；一齐，一致	
evacuate	[iˈvækjueit]	vt.	 撤离，疏散，排泄，剥夺	
equip	[iˈkwip]	v.	 （with）装备，配备；训练	
wild	[waild]	adj.	 野性的，野生的；野蛮的；狂热的；荒芜的	
rape	[reip]	n.	 掠夺，蹂躏，强奸	
radiate	[ˈreidieit]	v.	 放射，辐射；散布，传播	
eleven	[ɪˈlevən]	adj.	 十一（个，只…）	
staircase	[ˈstɛəkeis]	n.	 （stairway）楼梯	
surname	[ˈsə:neim]	n.	 姓	
beverage	[ˈbevəridʒ]	n.	 （水，酒等之外的）饮料	
save	[seiv]	v.	 救，拯救；储蓄，贮存；节省	
rash	[ræʃ]	n.	 皮疹	
preferable	[ˈprefərəbl]	adj.	 （to）更可取的，更好的	
knock	[nɔk]	n.	 敲，击	
preceding	[priˈsi:diŋ]	adj.	 在前的，在先的	
dialect	[ˈdaiəlekt]	n.	 方言	
specific	[spiˈsifik]	adj.	 明确的，具体的；特定的，特有的	
token	[ˈtəukən]	adj.	 象征性的	
shore	[ʃɔ:]	n.	 海滨，湖滨	
discreet	[disˈkri:t]	adj.	 （言行）谨慎的；慎重的；有判断力的	
homogeneous	[ˌhɔməˈdʒi:njəs]	adj.	 同种类的，同性质的，有相同特征的	
evade	[iˈveid]	vt.	 逃避，回避；避开，躲避	
habitat	[ˈhæbɪˌtæt]	n.	 （动物的）栖息地，（植物的）产地	
record	[ˈrekɔ:d]	n.	 记录；录音	
plague	[pleiɡ]	vt.	 折磨，使苦恼	
overcoat	[ˈəuvəkəut]	n.	 外衣，大衣	
while	[hwail]	n.	 一会儿	
amateur	[ˈæmətə]	adj.	 业余的，非职业的；业余爱好者	
burst	[bə:st]	n.	 突然破裂，爆发	
volt	[vəult]	n.	 伏特	
alert	[əˈlə:t]	v.	 使意识到，警惕	
learned	[ˈlə:nid]	adj.	 博学的，有学问的	
constrain	[kənˈstrein]	vt.	 限制，约束；克制，抑制	
puzzle	[ˈpʌzl]	v.	 （使）迷惑，（使）为难	
self	[self]	n.	 自我，自己	
explanation	[ˌekspləˈneiʃən]	n.	 解释，说明；理由，原因	
logic	[ˈlɔdʒik]	n.	 逻辑，逻辑学	
locality	[ləuˈkæliti]	n.	 位置，地点	
flexible	[ˈfleksəbl]	adj.	 柔韧的，易弯曲的，灵活的，能变形的	
later	[ˈleitə]	adv.	 后来，过后	
allocate	[ˈæləkeit]	v.	 分配，分派；拨给；划归	
best	[best]	adv.	 最好地；最，极	
shrug	[ʃrʌɡ]	vt.	 耸肩（表示冷淡、怀疑、无奈、不满等）	
protest	[ˈprəutest]	n.	 抗议，反对	
supervise	[ˈsju:pəvaiz]	v.	 管理，监督	
entire	[inˈtaiə]	adj.	 完全的，全部的，完整的	
extensive	[iksˈtensiv]	adj.	 广大的，广阔的；巨大的	
moist	[mɔist]	adj.	 潮湿的，湿润的，多雨的	
inch	[intʃ]	n.	 英寸	
frost	[frɒst]	n.	 霜，霜冻，严寒	
with	[wið]	prep.	 跟…一起；用；具有；关于；因；随着	
next	[nekst]	adv.	 其次；居后	
blend	[blend]	v.	 混和，混杂	
banana	[bəˈnɑ:nə]	n.	 香蕉	
discipline	[ˈdisiplin]	n.	 纪律，学科	
plateau	[ˈplætəu]	n.	 高原，平稳状态[时期]	
carpenter	[ˈkɑːpəntə(r)]	n.	 木工，木匠	
silicon	[ˈsilikən]	n.	 硅	
mortgage	[ˈmɔ:ɡidʒ]	n.	 抵押（借款）	
phase	[feiz]	n.	 阶段，状态，时期；相，相位	
likely	[ˈlaikli]	adv.	 大概，多半	
vitamin	[ˈvitəmin]	n.	 维生素	
conscientious	[ˌkɔnʃiˈenʃəs]	adj.	 审慎正直的，认真的，本着良心的	
increase	[inˈkri:s]	v.	 增加，增长，增进	
end	[end]	v.	 终止，结束	
channel	[ˈtʃænl]	n.	 海峡，水道；信道，波道；路线，途径	
chef	[ʃef]	n.	 （餐馆等的）厨师长，厨师	
duty	[ˈdju:ti]	n.	 义务，责任；职务；税	
spacecraft	[ˈspeiskrɑ:ft]	n.	 宇宙飞船	
football	[ˈfutbɔ:l]	n.	 足球	
sharp	[ʃɑ:p]	adv.	 猛烈地； 尖锐地； 尖利地； 偏高地 	
prolong	[prəˈlɔŋ]	v.	 拉长，延长，拖延	
transfer	[trænsˈfə:]	vt.	 转移；转换；转让；过户；迁移；改乘	
tremendous	[triˈmendəs]	adj.	 巨大的，极大的	
release	[riˈli:s]	n.	 释放，豁免，放松	
answer	[ˈɑ:nsə]	v.	 回复，解答，响应	
hurt	[hə:t]	v.	 刺痛，伤害；伤…的感情	
mud	[mʌd]	v.	 弄脏，使沾污泥	
axis	[ˈæksis]	n.	 轴，轴线，中心线；坐标轴，基准线	
conform	[kənˈfɔ:m]	vi.	 （to）遵守，适应；相似，一致，符合	
coincide	[ˌkəuinˈsaid]	vi.	 同时发生；巧合；一致；相符	
gasoline	[ˈɡæsəli:n]	n.	 （gasolene）汽油	
tropic	[ˈtrɔpik]	n.	 回归线；热带地区	
resume	[riˈzju:m]	n.	 再继续，重新开始；再用；恢复	
substantial	[səbˈstænʃəl]	adj.	 实质的；相当的；显著的；坚固的；富裕的	
false	[fɔːls]	adj.	 谬误的，虚伪的，伪造的，假的	
exhibit	[iɡˈzibit]	n.	 展览品，陈列品	
belief	[biˈli:f]	n.	 信任，信念；信仰，信条	
neck	[nek]	n.	 颈脖	
your	[jɔ:]	pron.	 [you的所有格]你的，你们的	
expert	[ˈekspə:t]	adj.	 熟练的，有经验的；专门的	
depend	[diˈpend]	v.	 （on）取决于，依靠，信赖，相信	
surrender	[səˈrendə]	n.	 投降，认输	
notwithstanding	[ˌnɔtwiθˈstændiŋ]	prep.	 尽管	
reception	[riˈsepʃən]	n.	 接待，招待会；接收，接受，接收效果	
possibly	[ˈpɒsəbli]	adv.	 可能地，也许；无论如何	
regulate	[ˈreɡjuleit]	v.	 管制，控制；调节，校准；调整	
precaution	[priˈkɔ:ʃən]	n.	 预防，谨慎，警惕	
belt	[belt]	n.	 （皮）带，腰带；地带	
tropical	[ˈtrɔpikəl]	adj.	 热带的	
valley	[ˈvæli]	n.	 （山）谷；流域	
tolerate	[ˈtɔləreit]	vt.	 容忍，默许；对（药物、毒品等）有耐力	
Christmas	[ˈkrisməs]	n.	 圣诞节	
exterior	[eksˈtiəriə]	n.	 外部	
navy	[ˈneivi]	n.	 海军	
menu	[ˈmenju:]	n.	 菜单	
can	[kæn]	vt.	 把…装罐	
waken	[ˈweikən]	v.	 醒，弄醒，唤醒	
antenna	[ænˈtenə]	n.	 天线；触角，触须	
rot	[rɒt]	v.	 （使）腐烂，（使）腐败，腐朽	
imitate	[ˈimiteit]	v.	 模仿，仿效；仿造，伪造	
rectangle	[ˈrektæŋɡl]	n.	 [数]矩形，长方形	
medieval	[ˌmediˈi:vəl]	adj.	 中世纪的，中古（时代）的，老式的，原始的	
foot	[fut]	n.	 脚，足；英尺；底部	
humidity	[hju:ˈmiditi]	n.	 湿气，湿度	
stand	[stænd]	n.	 台，座；货摊；立场	
expand	[iksˈpænd]	v.	 （使）膨胀，（使）扩张；张开，展开	
scene	[si:n]	n.	 景色，景象，舞台；（戏）一场	
descent	[diˈsent]	n.	 下降，降下；斜坡；血统，家世	
heaven	[ˈhevn]	n.	 天，天空，天堂；（Heaven）上帝，神	
bleed	[bli:d]	v.	 出血，流血	
radioactive	[ˌreidiəuˈæktiv]	adj.	 放射性，放射引起的	
suppose	[səˈpəuz]	conj.	 假使…结果会怎样	
accumulate	[əˈkju:mjuleit]	vi.	 累积，聚积	
kingdom	[ˈkiŋdəm]	n.	 王国，领域	
standpoint	[ˈstændpɔint]	n.	 立场，观点，角度	
lower	[ˈləuə]	v.	 降下，放低	
relevant	[ˈreləvənt]	adj.	 有关的，中肯的，相应的，实质性的	
review	[	n.	 回顾，复习；评论	
lively	[ˈlaivli]	adj.	 活泼的，活跃的；栩栩如生的，真实的	
playground	[ˈpleiɡraund]	n.	 运动场，游戏场	
harsh	[hɑ:ʃ]	adj.	 粗糙的；（声音）刺耳的；苛刻的，严酷的	
selection	[siˈlekʃən]	n.	 选择，挑选；选集，精选物	
poison	[ˈpɔizən]	v.	 放毒，毒害，污染	
stumble	[ˈstʌmbl]	vi.	 绊（摔）倒；结结巴巴说	
satisfy	[ˈsætisfai]	v.	 满意，使满意，使相信，说服	
fabric	[ˈfæbrik]	n.	 织物；织品；结构；构造；建筑物	
starve	[stɑ:v]	v.	 （使）饿死，饿得慌，挨饿	
boundary	[ˈbaundəri]	n.	 分界线，边界	
device	[diˈvais]	n.	 装置，设备，仪表；方法，设计	
dig	[diɡ]	v.	 挖，掘	
agenda	[əˈdʒendə]	n.	 议事日程，记事册	
translate	[trænsˈleit]	v.	 翻译，解释；转化	
lad	[læd]	n.	 男孩，小伙子	
soul	[səul]	n.	 灵魂，心灵；精神，精力；人	
atom	[ˈætəm]	n.	 原子；微粒，微量	
use	[ju:z]	vt.	 使用；消耗	
interesting	[ˈintristiŋ]	adj.	 有趣的，引人入胜的	
margin	[ˈmɑ:dʒin]	n.	 页边空白；边缘；余地；幅度	
upgrade	[ˌʌpˈɡreid]	v.	 提升，使升级	
transaction	[trænˈzækʃən]	n.	）会报，学报	
salt	[sɔ:lt]	v.	 腌，盐渍	
expire	[iksˈpaiə]	v.	 期满，（期限）终止；呼气；断气，死亡	
modernization	[ˌmɔdənaɪˈzeɪʃən]	n.	 （modernisation）现代化	
tactic	[ˈtæktik]	n.	 （tactics）策略，战术	
equation	[iˈkweiʃən]	n.	 （数学）等式，方程式；（with）相等；均衡	
famous	[ˈfeiməs]	adj.	 著名的	
vivid	[ˈvivid]	adj.	 鲜艳的；生动的，栩栩如生的	
conduct	[	n.	 引导；管理；指挥（乐队）；传导	
naive	[nɑ:ˈi:v]	adj.	 天真的	
familiar	[fəˈmiljə]	n.	 熟客；密友	
wretched	[ˈretʃid]	adj.	 可怜的；悲惨的；肮脏的；恶劣的	
transcend	[trænˈsend]	vt.	 超出，超越（经验、知识、能力的范围等）	
horrible	[ˈhɔrəbl]	adj.	 令人恐惧的，可怕的；极讨厌的，糟透的	
pan	[pæn]	n.	 平底锅，盘子，面板	
appetite	[ˈæpitait]	n.	 食欲，胃口；欲望，渴望；爱好，趣味	
dictation	[dikˈteiʃən]	n.	 听写，口述；命令	
ambassador	[æmˈbæsədə]	n.	 大使；特使，（派驻国际组织的）代表	
secretary	[ˈsekrətəri]	n.	 秘书，书记；部长，大臣	
geology	[dʒiˈɔlədʒi]	n.	 地质（学）	
surge	[sə:dʒ]	n.	 巨浪；汹涌；彭湃	
lip	[lip]	n.	 嘴唇	
electron	[iˈlektrɔn]	n.	 电子	
friendly	[ˈfrendli]	adj.	 友好的，友谊的	
grant	[ɡrɑ:nt]	n.	 授予物；津贴；转让证书	
render	[ˈrendə]	v.	 使得，致使；提出，提供，呈报	
straightforward	[streitˈfɔ:wəd]	adv.	 坦率地	
painful	[ˈpeinful]	adj.	 疼痛的，使痛苦的，费力[心]的，棘手的	
extract	[iksˈtrækt]	n.	 拔出，抽出；摘录；抽取物；精华；选集	
pledge	[pledʒ]	v.	 发誓；保证	
demonstrate	[ˈdemənstreit]	v.	 论证，证实；演示，说明	
verse	[və:s]	n.	 韵文，诗；诗节，诗句	
monitor	[ˈmɔnitə]	v.	 监控，监测	
hurricane	[ˈhʌrikən]	n.	 飓风	
indication	[ˌɪndiˈkeiʃən]	n.	 迹象；暗示	
loaf	[ləuf]	n.	 一个面包	
worship	[ˈwə:ʃip]	v.	 崇拜，敬仰；做礼拜	
ash	[æʃ]	n.	骨灰；废墟）	
passage	[ˈpæsidʒ]	n.	 通过，经过；通路，走廊；（一）段落，（一）节	
stack	[stæk]	v.	 堆积，堆起	
draw	[drɔ:]	n.	 平局；拖曳	
realm	[relm]	n.	 王国，国土；领域	
rectify	[ˈrektifai]	v.	 纠正，整顿，[化]精馏	
zone	[zəun]	v.	 分区，划分地带	
orbit	[ˈɔ:bit]	v.	 （使）沿轨道行	
beat	[bi:t]	v.	 打败；（心脏等）跳动	
organic	[ɔ:ˈɡænik]	adj.	 器官的；有机的；有机体的	
musician	[mju:ˈziʃən]	n.	 音乐家，乐师	
vanity	[ˈvæniti]	n.	 虚荣心，浮华	
addict	[ˈædikt]	n.	 沉溺于不良嗜好的人	
teenager	[ˈti:neidʒə]	n.	 十几岁的青少年	
thrift	[θrift]	adj.	 节约，节俭	
roll	[rəul]	n.	 卷，卷形物；名单	
basin	[ˈbeisn]	n.	 盆，脸盆；内海，盆地	
clause	[klɔ:z]	n.	 （正式文件或法律文件的）条款；从句，分句	
officer	[ˈɔfisə]	n.	 官员，办事员；工作人员；军官	
china	[ˈtʃainə]	n.	 瓷器	
intercourse	[ˈintəkɔ:s]	n.	 交流，交往，交际，性交	
spelling	[ˈspeliŋ]	n.	 拼法，拼写法	
cost	[kɔst]	v.	 价值为，花费	
mind	[maind]	v.	 注意，介意，反对	
dance	[dɑ:ns]	v.	 跳舞；跳动	
congratulation	[kənˌɡrætjuˈleiʃən]	n.	 （on）祝贺，祝贺词	
up	[ʌp]	adj.	 现代化的，最新的；跟上时代的	
meditation	[ˌmedɪˈteɪʃən]	n.	 熟虑；（尤指宗教的）默想，沉思；冥想录	
excuse	[iksˈkju:z]	n.	 借口，辩解	
analogue	[ˈænəˌlɔ:g]	n.	 类似物；相似体；模拟	
current	[ˈkʌrənt]	adj.	 当前的；流通的	
economics	[ˌɪkəˈnɔmiks]	n.	 经济学，经济情况	
undergraduate	[ˌʌndəˈɡrædjuit]	n.	 大学生，大学肆业生	
refrain	[riˈfrein]	n.	 （诗的）叠句	
conspiracy	[kənˈspirəsi]	n.	 阴谋，密谋，共谋	
pass	[pɑ:s]	n.	 通行证；考试及格	
clumsy	[ˈklʌmzi]	adj.	 笨拙的，愚笨的；得罪人的	
profitable	[ˈprɔfitəbl]	adj.	 有利可图的，有益的	
packet	[ˈpækit]	n.	 小包裹，小捆；盒；一捆，一扎；邮船，班轮	
ticket	[ˈtikit]	n.	 票，入场券；票签；（交通违章）罚款传票	
lodge	[lɔdʒ]	n.	 传达室，小旅馆	
uneasy	[ˌʌnˈi:zi]	adj.	 不安的，焦虑的	
follow	[ˈfɔləu]	v.	 跟随，接着；领会；沿着…前进，遵循；结果是	
impulse	[ˈimpʌls]	n.	 推动；冲动，刺激	
congress	[ˈkɔŋɡres]	n.	 （代表）大会；（美国等国的）国会，议会	
scandal	[ˈskændl]	n.	 丑闻，诽谤，耻辱，流言蜚语，反感，公愤	
become	[biˈkʌm]	vt.	 适合，同…相称	
being	[ˈbi:ɪŋ]	n.	 生物，生命；存在	
patient	[ˈpeiʃənt]	n.	 病人，患者	
cottage	[ˈkɔtidʒ]	n.	 村舍，小屋，别墅	
sunrise	[ˈsʌnraiz]	n.	 日出，拂晓；朝霞	
maneuver	[məˈnu:və]	v.	 演习；移动	
appliance	[əˈplaiəns]	n.	 电器；器械，装置；应用，适用	
vinegar	[ˈviniɡə]	n.	 醋	
worthy	[ˈwə:ði]	adj.	 （of）值得…的，配得上…的；有价值的	
sorrow	[ˈsɔrəu]	n.	 悲衰，悲痛	
questionnaire	[ˌkwestiəˈnɛə]	n.	 调查表，问卷	
glance	[ɡlɑ:ns]	n.	 匆匆一看，一瞥	
pat	[pæt]	v.	 轻拍，轻打，抚摸	
partial	[ˈpɑ:ʃəl]	adj.	 部分的，不完全的；偏袒的，不公平的，偏爱的	
mixture	[ˈmikstʃə]	n.	 混合；混合物，混合剂	
heading	[ˈhediŋ]	n.	 标题	
divorce	[diˈvɔ:s]	v.	 离婚，分离	
incur	[inˈkə:]	v.	 招致，惹起，遭受	
disposition	[ˌdispəˈziʃən]	n.	 排列，部署；性格倾向；倾向，意向	
north	[nɔ:θ]	adv.	 向北方，在北方	
thirteen	[θɜ:ˈti:n]	pron.	 十三（个，只…）	
personal	[ˈpə:sənəl]	adj.	 个人的，私人的；亲自的；身体的，人身的	
himself	[himˈself]	pron.	 [反身代词]他自己；他本人	
drum	[drʌm]	n.	 鼓；圆桶	
obstacle	[ˈɔbstəkl]	n.	 障碍（物），妨碍，阻碍，干扰	
rigid	[ˈridʒid]	adj.	 刚性的；刻板的；严厉的	
whenever	[hwenˈevə]	conj.	 无论何时，随时；每当	
path	[pɑ:θ]	n.	 小路，小径；路线，轨道	
warm	[wɔ:m]	v.	 （使）变暖	
correlate	[ˈkɔrileit]	v.	 （with，to）（使）互相关联	
angry	[ˈæŋɡri]	adj.	 生气的，愤怒的；（天气）风雨交加的	
geography	[dʒiˈɔɡrəfi]	n.	 地理（学），地形，地势	
opaque	[əuˈpeik]	adj.	 不透明（光）的；难理解的，晦涩的	
beyond	[biˈjɔnd]	prep.	 在（或向）…的那边，远于；超出	
lazy	[ˈleizi]	adj.	 懒惰的，懒散的	
jar	[dʒɑ:]	n.	 罐子，坛子，广口瓶；一罐，一坛	
rigorous	[ˈriɡərəs]	adj.	 严格的，严厉的，严酷的，严密的，严谨的	
analyse	[ˈænəlaiz]	vt.	 （analyze）分析，分解	
latter	[ˈlætə]	n.	 后者	
petty	[ˈpeti]	adj.	 小（器、规模）的，不重要的，细微的，卑鄙的	
nasty	[ˈnɑ:sti]	adj.	 肮脏的，卑劣的，下流的；令人厌恶的	
show	[ʃəu]	v.	 上演（戏剧等），放映（电影）；说明，表明	
cotton	[ˈkɔtən]	n.	 棉花；棉线，棉纱；棉制品	
awe	[ɔ:]	vt.	 使敬畏，使惊惧	
donkey	[ˈdɔŋki]	n.	 驴子；蠢人；顽固的人	
streamline	[ˈstri:mlain]	vt.	 使成流线型；使合理化	
positive	[ˈpɔzitiv]	adj.	 肯定的，积极的，绝对的，无疑的，正的	
majesty	[ˈmædʒisti]	n.	 雄伟，壮丽，庄严，威严；最高权威，王权	
deputy	[ˈdepjuti]	adj.	 副的，代理的	
retire	[riˈtaiə]	v.	 退休，引退；退却，撤退；就寝	
violent	[ˈvaiələnt]	adj.	 猛烈的，激烈的；暴力引起的，强暴的	
freeze	[fri:z]	v.	 使结冰，使凝固	
throne	[θrəun]	n.	 御座，宝座；王位，王权	
instruction	[inˈstrʌkʃən]	n.	 教授；指导；用法说明（书），操作指南	
chance	[tʃɑ:ns]	v.	 碰巧，偶然发生	
durable	[ˈdjuərəbl]	adj.	 持久的，耐久的	
billion	[ˈbiljən]	num.	 （美）十亿，（英）万亿	
probe	[prəub]	v.	 （以探针等）探查，穿刺，查究	
powerful	[ˈpauəful]	adj.	 强大的，有力的，有权的	
petroleum	[piˈtrəuliəm]	n.	 石油	
castle	[ˈkɑːsl]	n.	 城堡；（国际象棋中的）车	
orient	[ˈɔ:riənt]	v.	 使朝东，为…定位，使适应	
carry	[ˈkæri]	v.	 运送，搬运；传送，传播；领，带	
appearance	[əˈpiərəns]	n.	 出现，露面；外表；作短暂露面	
talent	[ˈtælənt]	n.	 才能，天资；人才	
both	[bəuθ]	adj.	 两个…（都）	
its	[its]	pron.	 [it的所有格]它的	
resolve	[riˈzɔlv]	n.	 解决；决心	
hollow	[ˈhɔləu]	v.	 挖空，凿空	
revise	[riˈvaiz]	v.	 修订，校订；修正，修改	
breadth	[bredθ]	n.	 宽度，幅	
fisherman	[ˈfiʃəˌmən]	n.	 渔夫，捕鱼人	
bubble	[ˈbʌbl]	v.	 冒泡，起泡，沸腾	
centre	[ˈsentə]	vi.	 以…为中心	
chamber	[ˈtʃeimbə]	n.	 房间，室；会议室；议院；腔室	
competitive	[kəmˈpetitiv]	adj.	 竞争的；好竞争的；（价格等的）有竞争力的	
descend	[diˈsend]	v.	 下来，下降；遗传（指财产，气质，权利）	
network	[ˈnetwə:k]	n.	 网状物；广播网，电视网；网络	
formula	[ˈfɔ:mjulə]	n.	formulae）公式；规则；分子式；药方	
unify	[ˈju:nifai]	v.	 使联合，统一；使相同，使一致	
weekday	[ˈwi:kdei]	n.	 平常日，工作日	
hear	[hiə]	v.	 听见；审讯；（from）收到…的信/电话；听说	
nine	[naɪn]	pron.	 九（个，只…）	
nursery	[ˈnə:səri]	n.	 托儿所	
affluent	[ˈæfluənt]	adj.	 富裕的，富有的，丰富的，富饶的	
renovate	[ˈrenəveit]	v.	 更新，修复	
behavior	[bɪˈheɪvjə]	n.	 （behaviour）行为，举止；（机器等）运转情况	
rebellion	[riˈbeliən]	n.	 叛乱，反抗，起义	
habit	[ˈhæbit]	n.	 习惯，习性，脾性	
spin	[spin]	n.	 旋转；自转	
camp	[kæmp]	v.	 设营，宿营	
bargain	[ˈbɑ:ɡin]	v.	 议价，成交	
stab	[stæb]	v.	 刺，戳	
dusk	[dʌsk]	n.	 薄暮，黄昏	
collect	[kəˈlekt]	v.	 收集，搜集；领取，接走；收（税等）；聚集，堆积	
mourn	[mɔ:n]	v.	 哀悼，忧伤	
vulgar	[ˈvʌlɡə]	adj.	 粗俗的，庸俗的，本土的，普通的	
instrumental	[ˌɪnstruˈmentl]	adj.	 仪器的；器械的；乐器的；起作用的；有帮助的	
peak	[pi:k]	adj.	 高峰的，最高的	
illuminate	[iˈlju:mineit]	vt.	 照亮，照明；用灯光装饰；说明，阐释	
fireman	[ˈfaiəmən]	n.	 消防队员	
ore	[ɔ:]	n.	 矿石，矿砂	
in	[in]	adv.	 进，入	
abdomen	[ˈæbdəmən]	n.	 腹，下腹；腹腔	
daylight	[ˈdeilait]	n.	 日光，白昼，黎明	
but	[bʌt]	adv.	 只，才，仅仅	
universe	[ˈju:nivə:s]	n.	 宇宙，万物	
permeate	[ˈpə:mieit]	v.	 弥漫，遍布，散布；渗入，渗透	
monotonous	[məˈnɔtənəs]	adj.	 单调的，无变化的	
moral	[ˈmɔ:rəl]	n.	 寓意，教育意义	
ridiculous	[riˈdikjuləs]	adj.	 荒谬的，可笑的	
trolley	[ˈtrɔli]	n.	 手推车；（英）无轨电车，（美）有轨电车	
zero	[ˈziərəu]	num.	 零	
praise	[preiz]	n.	 称赞，赞美；赞美的话	
capture	[ˈkæptʃə]	v.	 捕获，俘虏；夺得，攻占	
accidental	[ˌæksiˈdentl]	adj.	 偶然的；意外的；无意中的	
blank	[blæŋk]	n.	 空白；表格	
paperback	[ˈpeipəbæk]	n.	 平装本，简装本	
panorama	[ˌpænəˈrɑ:mə]	n.	 全景，全景画，全景摄影，全景照片[装置]	
steal	[sti:l]	v.	 偷，窃取；偷偷地做，巧取	
betray	[biˈtrei]	v.	 背叛，出卖；暴露，流露，泄露	
model	[ˈmɔdəl]	v.	 模仿	
leading	[ˈli:diŋ]	adj.	 领导的，指导的；第一位的；最主要的	
account	[əˈkaunt]	vi.	 说明，解释	
classroom	[ˈklɑ:sru:m]	n.	 教室，课堂	
sail	[seil]	v.	 航行	
cloth	[klɔθ]	n.	 （一块）布，织物，衣料	
tariff	[ˈtærif]	n.	 关税，税率；价目表，收费表	
oriental	[ˌɔ:riˈentəl]	n.	 东方人	
scare	[skeə]	v.	 惊吓，受惊	
because	[biˈkɔz]	conj.	 因为，由于	
part	[pɑ:t]	v.	 使分开	
keen	[ki:n]	adj.	 渴望的；热切的；热衷的；热情的	
nickel	[ˈnikəl]	n.	 镍；镍币；五美分	
stupid	[ˈstju:pid]	adj.	 愚蠢的，迟钝的	
delicate	[ˈdelikit]	adj.	 纤弱的；精致的；微妙的；灵敏的	
dragon	[ˈdræɡən]	n.	 龙	
cheese	[tʃi:z]	n.	 干酪，乳酪	
I	[aɪ]	pron.	 （主格）我	
visible	[ˈvizəbl]	adj.	 看得见的，明显的，显著的	
restrain	[risˈtrein]	v.	 抑制，制止	
urge	[ə:dʒ]	n.	 强烈欲望，迫切要求	
help	[help]	n.	 帮助，帮手	
odor	['əʊdə]	n.	 （odour）气味，香味，臭味，名声	
susceptible	[səˈseptəbl]	adj.	 易受影响的；易受感动的；易受感染的	
could	[kud]	v.	 （口语）（表示许可或请求）可以…，行	
Thanksgiving	[θæŋksˈgɪvɪŋ]	n.	 感恩节	
pirate	[ˈpaiərit]	n.	 海盗，盗版（者）	
seem	[si:m]	v.	 好像，似乎	
intellectual	[ˌɪntiˈlektjuəl]	adj.	 智力的，理智的，有理解力的	
family	[ˈfæmili]	n.	 家，家庭成员；氏族，家庭；族，科	
where	[hwɛə]	conj.	 然而	
consequence	[ˈkɔnsikwəns]	n.	 结果，后果，影响；重要性	
radar	[ˈreidə]	n.	 雷达	
quarrel	[ˈkwɔrəl]	n.	 争吵，争吵的原因	
bulb	[bʌlb]	n.	 灯泡，球状物	
fine	[fain]	v.	 （对…处以）罚金，罚款	
shy	[ʃai]	vi.	 惊退，畏缩	
hope	[həup]	v.	 希望，期望	
prophet	[ˈprɔfit]	n.	 预言家；先知；提倡者	
absent	[ˈæbsənt]	adj.	 缺席的；缺乏的，不存在的；心不在焉的	
cry	[krai]	n.	 叫，喊，哭；（鸟兽）叫，啼，鸣，嗥	
appreciate	[əˈpri:ʃieit]	vt.	 为…表示感激，感谢；欣赏，赏识	
change	[tʃeindʒ]	v.	 更换，调换，交换；改变	
mutual	[ˈmju:tʃuəl]	adj.	 相互的，彼此的；共同的，共有的	
adjacent	[əˈdʒeisənt]	adj.	 （to）紧接着的；邻近的，毗邻的	
secure	[siˈkjuə]	v.	 得到；防护	
pinch	[pintʃ]	v.	 捏，掐，拧；收缩；紧急关头；匮乏；压力	
version	[ˈvə:ʃən]	n.	 版本；译本，译文；说法	
judicial	[dʒu:ˈdiʃəl]	adj.	 司法的，法庭的，审判的；明断的，公正的	
quart	[kwɔ:t]	n.	 夸脱	
without	[wiˈðaut]	adv.	 在外部；缺少	
sin	[sin]	v.	 犯罪	
legislation	[ˌledʒisˈleiʃən]	n.	 法律（规）；立法，法律的制定（或通过）	
thirst	[θə:st]	n.	 渴，口渴；（for）渴望，热望	
critical	[ˈkritikəl]	adj.	 批评的，评论的；危急，紧要的；临界的	
else	[els]	adv.	 其它，另外，别的；[与or连用]否则	
stomach	[ˈstʌmək]	vt.	 承受，忍受	
uphold	[ʌpˈhəuld]	vt.	 支持，赞成；举起；坚持	
exotic	[ɪɡˈzɒtɪk]	adj.	 奇异的；异国情调的；外（国）来的	
mess	[mes]	v.	 弄脏，弄乱，搞糟	
horse	[hɔ:s]	v.	 骑马	
term	[tə:m]	n.	 学期；期限，期间	
force	[fɔ:s]	v.	 强迫	
admire	[ədˈmaiə]	vt.	 钦佩，赞赏，羡慕；称赞，夸奖	
prosperous	[ˈprɔspərəs]	adj.	 繁荣的，兴旺的，茂盛的，顺利的	
devote	[diˈvəut]	v.	 （to）奉献，致力	
verbal	[ˈvə:bəl]	adj.	 用言辞的，用文字的；口头的；（动词）的	
agency	[ˈeidʒənsi]	n.	 代理（处）；代办处；机构	
swarm	[swɔ:m]	vi.	 涌往；挤满；云集；成群移动	
tonight	[təˈnait]	n.	 今晚，今夜	
intersection	[intəˈsekʃən]	n.	 交点；道路交叉口；十字路口	
lift	[lift]	n.	 电梯，上升，免费搭车	
native	[ˈneitiv]	n.	 本地人，本国人	
vision	[ˈviʒən]	n.	 视力，视觉；远见；洞察力；幻想，幻影；想象力	
exciting	[ikˈsaitiŋ]	adj.	 令人兴奋的，使人激动的	
savage	[ˈsævidʒ]	n.	 野人，未开化的人	
rocket	[ˈrɔkit]	n.	 火箭	
brilliant	[ˈbriljənt]	adj.	 光辉的，灿烂的；卓越的，有才华的	
for	[fɔ:]	conj.	 因为，由于	
often	[ˈɔfən]	adv.	 常常，经常，通常	
shelter	[ˈʃeltə]	v.	 掩蔽，躲避，庇护	
holy	[ˈhəuli]	adj.	 神圣的，圣洁的	
porch	[pɔ:tʃ]	n.	 门廊，入口处	
jaw	[dʒɔ:]	n.	 下巴；下颌	
recipient	[riˈsipiənt]	n.	 接受者，感受者，容器	
drug	[drʌɡ]	v.	 下麻药；吸毒	
knob	[nɔb]	n.	 门把，（球形）把手，旋纽	
stalk	[stɔ:k]	vi.	 高视阔步地走	
conclusion	[kənˈklu:ʒən]	n.	 结论，推论；结尾；缔结，议定	
compliment	[ˈkɔmplimənt]	v.	 称赞，恭维	
citizen	[ˈsitizən]	n.	 公民；市民，居民	
attorney	[əˈtə:ni]	n.	 代理人；辩护律师	
construct	[kənˈstrʌkt]	v.	 建设，建造，构造；创立	
prefer	[priˈfə:]	v.	 （to）更喜欢，宁愿	
tuck	[tʌk]	v.	 卷起；塞进	
pursue	[pəˈsju:]	v.	 追赶，追踪；继续，从事	
bare	[bɛə]	v.	 露出，暴露	
bachelor	[ˈbætʃələ]	n.	 单身汉；（亦作B-）学士（学位）	
lure	[luə]	vt.	 引诱，吸引	
weapon	[ˈwepən]	n.	 武器，兵器	
fragile	[ˈfrædʒail]	adj.	 易碎的，脆的，易损坏的；虚弱的，脆弱的	
silver	[ˈsilvə]	v.	 镀银	
cautious	[ˈkɔ:ʃəs]	adj.	 （of）小心的，谨慎的	
obsession	[əbˈseʃən]	n.	 迷住，困扰	
exempt	[iɡˈzempt]	n.	 免税者；被免除义务者	
table	[ˈteibl]	vt.	 搁置；提交讨论	
greeting	[ˈɡri:tiŋ]	n.	 问候，致敬	
fool	[fu:l]	vi.	 干蠢事	
shove	[ʃʌv]	n.	 猛推	
obedience	[əʊˈbi:di:əns]	n.	 服从，顺从	
automation	[ˌɔ:təˈmeiʃən]	n.	 自动，自动化，自动操作	
balance	[ˈbæləns]	n.	 天平；平衡，均衡；差额，余款	
crack	[kræk]	v.	 （使）破裂，砸开	
wardrobe	[ˈwɔ:drəub]	n.	 衣柜，；衣服；行头；剧装	
float	[fləut]	v.	 浮动；漂浮；传播；动摇	
indifferent	[inˈdifrənt]	adj.	 不感兴趣的；不关心的；冷淡的	
search	[sə:tʃ]	v.	 （for）搜索，寻找，探查	
early	[ˈɜrli	adv.	 早，在初期	
corrode	[kəˈrəud]	v.	 （受）腐蚀，侵蚀	
horizontal	[ˌhɔriˈzɔntəl]	adj.	 地平线的；水平的	
sure	[ʃuə]	adj.	 肯定的；一定会…的；有信心的，有把握的	
please	[pli:z]	v.	 请；使愉快，使满意；喜欢，愿意	
comprehensive	[ˌkɔmpriˈhensiv]	adj.	 内容广泛的，总括性的，综合的	
orderly	[ˈɔ:dəli]	n.	 勤务兵	
elect	[iˈlekt]	v.	 选举，推选；选择，作出选择	
clear	[kliə]	vi.	 变清澈	
metre	[ˈmi:tə]	n.	 （meter）米，公尺；仪表，计量器	
illegal	[iˈli:ɡəl]	adj.	 不合法的，非法的	
mirror	[ˈmirə]	v.	 反映，反射	
rule	[ru:l]	n.	 规章，条例；习惯；统治	
resident	[ˈrezidənt]	adj.	 居住的	
enclosure	[inˈkləuʒə]	n.	 围场；圈占地；附件	
national	[ˈnæʃənəl]	adj.	 民族的，国家的，国立的	
deal	[di:l]	n.	 交易	
dispose	[disˈpəuz]	v.	 （of）处理，处置；（for）布置，安排	
three	[θri:]	adj.	 三（个，只…）的	
passenger	[ˈpæsindʒə]	n.	 乘客，旅客	
September	[səpˈtembə]	n.	 九月	
win	[win]	n.	 胜利	
software	[ˈsɔftwɛə]	n.	 软件	
product	[ˈprɔdʌkt]	n.	 产品，产物；乘积	
pact	[pækt]	n.	 合同，条约，公约，协定	
relieve	[riˈli:v]	v.	 减轻，解除，援救，救济，换班	
shutter	[ˈʃʌtə]	n.	 百叶窗；（照相机）快门；关闭装置	
catalog	[ˈkætəlɔɡ]	v.	 编目（录）	
morality	[məˈræliti]	n.	 道德，美德	
pond	[pɔnd]	n.	 池塘	
necessitate	[niˈsesiteit]	v.	 使成为必要，需要	
agent	[ˈeidʒənt]	n.	 代理人；代理商	
soap	[səup]	n.	 肥皂	
infinite	[ˈinfinit]	n.	 无限	
standard	[ˈstændəd]	adj.	 标准的	
still	[stil]	adv.	 还，仍然；更；安静地	
straight	[streit]	adv.	 直接；正直，直率	
cocaine	[kəuˈkein]	n.	 可卡因，古柯碱（用作局部麻醉剂）	
monkey	[ˈmʌŋki]	n.	 猴子	
subsidy	[ˈsʌbsidi]	n.	 补助金；津贴费	
jolly	[ˈdʒɒli]	adj.	 欢乐的，高兴的	
overlook	[ˌəuvəˈluk]	v.	 看漏，忽略；俯瞰，眺望；宽容，放任	
suit	[sju:t]	n.	 一套西服；诉讼	
outside	[ˌautˈsaid]	prep.	 在…外	
sudden	[ˈsʌdən]	adj.	 出乎意料的，突然的	
moreover	[mɔ:ˈrəuvə]	conj.	 再者，加之，而且	
multiple	[ˈmʌltipl]	v.	 成倍增加	
apart	[əˈpɑ:t]	adj.	 分离的，分隔的	
practise	[ˈpræktis]	v.	 练习，实习，实践，实行，使…练习，训练	
finding	[ˈfaindiŋ]	n.	）调查/研究结果	
auto	[ˈɔːtəʊ]	n.	 （automobile）（口语）汽车	
hearing	[ˈhiəriŋ]	n.	 听，倾听；听力；审讯	
variable	[ˈvɛəriəbl]	n.	 变量	
ball	[bɔ:l]	vt.	 把…捏成球状	
loosen	[ˈlu:sən]	v.	 解开，放松	
liver	[ˈlivə]	n.	 肝，肝脏	
grandmother	[ˈɡrændˌmʌðə]	n.	 祖母，外祖母	
arrange	[əˈreindʒ]	v.	 安排，筹划；整理排列，布置	
obligation	[ˌɔbliˈɡeiʃən]	n.	 义务，责任	
rack	[ræk]	v.	 使痛苦，折磨	
married	[ˈmærid]	adj.	 已婚的，夫妇的；（to）与…结婚的	
glue	[ɡlu:]	v.	 胶合，粘贴	
compound	[ˈkɔmpaund]	vt.	 混合	
absorb	[əbˈsɔ:b]	vt.	 吸收（水、光、蒸汽等）；使全神贯注	
fierce	[fiəs]	adj.	 凶猛的，残忍的；狂热的，强烈的	
welcome	[ˈwelkəm]	vt.	 欢迎；迎接	
hoist	[hɔist]	v.	 举起，升起，吊起	
aspire	[əsˈpaiə]	vi.	 （to，after）渴望，追求，有志于	
glare	[ɡlɛə]	n.	 强光；怒视；炫耀	
vain	[vein]	adj.	 徒劳的，徒然的；自负的，爱虚荣的	
industrialize	[inˈdʌstriəlaiz]	v.	 （industrialise）（使）工业化	
undergo	[ˌʌndəˈɡəu]	vt.	 遭受，经历，承受	
continent	[ˈkɔntinənt]	n.	 大陆，洲	
jungle	[ˈdʒʌŋɡl]	n.	 热带丛林；密林	
aisle	[ail]	n.	 （教堂、教室、戏院等里的）过道，通道	
premium	[ˈpri:miəm]	n.	 额外费用，奖金，奖赏，保险费	
start	[stɑ:t]	n.	 开端；惊起	
hypothesis	[haiˈpɔθisis]	n.	 假说，假设，前提	
garlic	[ˈɡɑ:lik]	n.	 蒜，大蒜粉	
inside	[inˈsaid]	prep.	 在…里	
missing	[ˈmisiŋ]	adj.	 漏掉的，失去的，失踪的	
bar	[bɑːr]	v.	 闩上，阻拦	
doubt	[daut]	n.	 怀疑，疑虑	
beware	[biˈwɛə]	v.	 当心，谨防	
arbitrary	[ˈɑ:bitrəri]	adj.	 任意的，任性的，主观的；专断的，武断的	
examine	[iɡˈzæmin]	v.	 细查，检查，调查；对…进行考试	
random	[ˈrændəm]	n.	 随机，随意	
suspend	[səˈspend]	v.	 悬（浮），挂；暂停，取消；推迟	
attendance	[əˈtendəns]	n.	 出席；出席人数；护理，照料	
therefore	[ˈðɛəfɔ:]	conj.	 因此	
brother	[ˈbrʌðə]	n.	 兄弟；同事，同胞	
hug	[hʌɡ]	v.	 热烈拥抱，紧抱	
tragic	[ˈtrædʒik]	adj.	 悲剧的，悲惨的	
crazy	[ˈkreizi]	adj.	 疯狂的，古怪的，蠢的；（about）狂热的	
provide	[prəˈvaid]	v.	 供应，供给，准备，预防，规定	
invaluable	[inˈvæljuəbl]	adj.	 非常宝贵的；极为有用的	
emphasize	[ˈemfəsaiz]	v.	 （emphasise）强调	
improvement	[imˈpru:vmənt]	n.	 改进，进步，增进；改进措施	
fragrant	[ˈfreɪgrənt]	adj.	 香的；芬芳的	
coherent	[kəuˈhiərənt]	adj.	 一致的，协调的；（话语等）条理清楚的	
escalate	[ˈeskəleit]	v.	 （使）逐步增长（或发展），（使）逐步升级	
try	[trai]	n.	 尝试	
most	[məust]	n.	 大多数	
empty	[ˈempti]	v.	 倒空，使成为空的	
apology	[əˈpɔlədʒi]	n.	 道歉，认错，辩解，辩护	
material	[məˈtiəriəl]	adj.	 物质的，肉体的，实质性的	
dog	[dɔɡ]	vt.	 尾随，跟踪	
considerable	[	adj.	 相当大（或多）的，可观的；值得考虑的	
implicit	[imˈplisit]	adj.	 含蓄的；（in）固有的；无疑问的；绝对的	
great	[ɡreit]	adj.	 伟大的；重要的；大量的；很好的；美好的	
wrist	[rist]	n.	 腕，腕关节	
incentive	[inˈsentiv]	n.	 刺激；激励；奖励	
confident	[ˈkɔnfidənt]	n.	 （of，in）确信的，自信的	
say	[sei]	vi.	 说，发表意见	
ensure	[inˈʃuə]	v.	 确保，保证；使安全	
sprinkle	[ˈspriŋkl]	n.	 洒，喷，淋	
marble	[ˈmɑ:bl]	n.	 大理石，云石	
compress	[kəmˈpres]	vt.	 压紧，压缩；（把思想、文字等）浓缩	
ruthless	[ˈru:θlis]	adj.	 残酷的，无情的	
startle	[ˈstɑ:tl]	v.	 惊吓，使吃惊	
birth	[bə:θ]	n.	 出生，诞生；出身，血统；起源；出现	
ear	[iə]	n.	 耳，耳朵；听力，听觉；穗	
simply	[ˈsimpli]	adv.	 简单地；完全，简直；仅仅；朴素地	
erosion	[iˈrəuʒən]	n.	 腐蚀，磨损；削弱，减少	
oral	[ˈɔrəl]	adj.	 口头的	
orientation	[ˌɔ:rienˈteiʃən]	n.	 方向，方位，定位，倾向性，向东方	
mat	[mæt]	n.	 席子，垫子	
approximate	[əˈprɔksimit]	vi.	 （to）接近	
financial	[faɪˈnænʃ(ə)l]	adj.	 财政的，金融的	
count	[kaunt]	n.	 计数，总数	
sob	[sɔb]	v.	 哭泣，呜咽	
anything	[ˈeniθiŋ]	pron.	 任何东西（事物）；无论什么东西（事物）	
unload	[ˌʌnˈləud]	vt.	 摆脱…之负担；倾销	
terrify	[ˈterifai]	v.	 使害怕，使惊恐	
maths	[mæθs]	n.	 （mathematics/math）数学	
apartment	[əˈpɑ:tmənt]	n.	 [英]房间，套间；[美]公寓	
story	[ˈstɔ:ri]	n.	 故事，小说；（=storey）楼层	
pave	[peiv]	v.	 铺砌，铺（路）	
scenery	[ˈsi:nəri]	n.	 风景，舞台布景	
banner	[ˈbænə]	n.	 旗（帜）	
menace	[ˈmenəs]	vt.	 有危险性的人（或物）；威胁，威吓	
lame	[leim]	adj.	 跛的，（辩解、论据等）无说服力的	
divert	[daiˈvə:t]	vt.	 使转向，使改道；转移（注意力）；使娱乐	
back	[bæk]	n.	 背；后面	
vacuum	[ˈvækjuəm]	n.	 真空，真空吸尘器	
layman	[ˈleimən]	n.	 外行	
stroke	[strəuk]	v.	 抚摸	
unlikely	[ʌnˈlaɪkli:]	adj.	 未必的，靠不住的	
okay	[ˌəuˈkei]	n.	 同意	
association	[əˌsəuʃiˈeiʃən]	n.	 联盟，协会，社团；交往，联合；联想	
grade	[ɡreid]	v.	 分等，分级	
burden	[ˈbə:dən]	vt.	 给予负担或麻烦	
smoke	[sməuk]	v.	 抽（烟）；冒烟，冒气	
worker	[ˈwə:kə]	n.	 工人，工作者，工作人员	
compensation	[ˌkɔmpenˈseiʃən]	n.	 补偿（或赔偿）的款物；补偿，赔偿	
uproar	[ˈʌpˌrɔ:]	n.	 骚动，喧嚣，鼎沸	
reporter	[riˈpɔ:tə]	n.	 报告人，通讯员；记者，报导者	
spread	[spred]	v.	 伸开，伸展；散布，传播	
yesterday	[ˈjestədi]	n.	 昨天；前不久	
mad	[mæd]	adj.	 发疯的；狂热的，着迷的；恼火的，生气的	
commemorate	[kəˈmeməreit]	vt.	 纪念，庆祝	
that	[ðæt]	conj.	 [引导从句]	
following	[ˈfɔləuiŋ]	adj.	 下列的，下述的，其次的，接着的	
good	[ɡud]	n.	 好处；利益	
laughter	[ˈlɑ:ftə]	n.	 笑，笑声	
tank	[tæŋk]	vt.	 储于槽中	
surprise	[səˈpraiz]	n.	 诧异，惊异；奇袭	
resist	[riˈzist]	v.	 抵抗，反抗；忍得住，抵制	
resolution	[ˌrezəˈlu:ʃən]	n.	 坚决，决心；决定，决议	
implication	[ˌɪmpliˈkeiʃən]	n.	 含意，暗示，暗指；牵连	
renew	[riˈnju:]	v.	 （使）更新，恢复，重新开始，继续	
pig	[piɡ]	n.	 猪，猪肉；猪一般的人（指肮脏，贪吃的人）	
feel	[fi:l]	vi.	 摸上去有…感觉；摸索；觉得	
score	[skɔ:]	v.	 得（分），记（…的）分数	
vocabulary	[vəˈkæbjuləri]	n.	 词汇，词汇量；词汇表	
club	[klʌb]	n.	 俱乐部，夜总会；社团；棍棒，球棒	
junction	[ˈdʒʌnkʃən]	n.	 连接，接合，交叉点，枢纽站，接头，中继线	
large	[lɑ:dʒ]	adj.	 大的，广大的，大规模的	
rabbit	[ˈræbit]	n.	 兔子	
lucky	[ˈlʌki]	adj.	 幸运的，侥幸的	
quiver	[ˈkwivə]	v.	 颤抖，抖动	
neither	[ˈni:ðə]	adv.	 也不	
desirable	[diˈzaiərəbl]	adj.	 值得做的；合意的，称心的；期望得到的	
ship	[ʃip]	v.	 装运，航运，运送；发货	
stone	[stəun]	n.	 石头；矿石；（水果的）核、子	
instead	[inˈsted]	adv.	 作为替代；反而；相反地	
fly	[flai]	adj.	 机敏的	
contemplate	[ˈkɔntempleit]	vt.	 盘算，计议；周密考虑；注视，凝视	
mount	[maunt]	n.	 支架，底板；（用于山名前）山峰	
differ	[ˈdifə]	v.	 与…不同；与…意见不同	
work	[wə:k]	v.	 工作；运转	
invariably	[ɪnˈveəriəbli]	adv.	 不变地，永恒地，总是	
heel	[hi:l]	n.	 脚后跟，踵，鞋跟	
prison	[ˈprizən]	n.	 监狱	
or	[ɔ:]	conj.	 或，或者（表示选择）；即，大约；否则	
solo	[ˈsəuləu]	adj.	 单独的（地）；独唱的（地）	
dynamic	[daiˈnæmik]	adj.	 动力的，电动的；有生气的	
dynasty	[ˈdainəsti]	n.	 王朝，朝代	
retrospect	[ˈretrəspekt]	v.	 回顾，回想，追溯[反]foresee	
chart	[tʃɑ:t]	vt.	 绘图表，制图表	
sway	[swei]	n.	 摇动；影响力	
inference	[ˈinfərəns]	n.	 推论，推理，推断；结论	
dizzy	[ˈdizi]	adj.	 头晕目眩的，眩晕的；使人头晕的	
ton	[tʌn]	n.	）大量，许多	
declaration	[ˌdekləˈreiʃən]	n.	 宣言，宣布，声明	
aware	[əˈwɛə]	adj.	 知道的，意识到的	
witness	[ˈwitnis]	v.	 目击，目睹；作证	
tissue	[ˈtisju:]	n.	 织物，薄绢，纸巾；（动植物的）组织	
disguise	[disˈɡaiz]	n.	 假装，伪装	
segregate	[ˈseɡriɡeit]	vt.	 使···分开，隔离（病患等）	
kettle	[ˈketl]	n.	 水壶	
conventional	[kənˈvenʃənl]	adj.	 惯例的，常规的	
amplifier	[ˈæmpləˌfaɪə]	n.	 放大器，扩大器	
earth	[ə:θ]	n.	 地球；陆地；泥土，土壤；尘世，人间	
doctor	[ˈdɔktə]	vt.	 授以博士学位；诊断；修改；篡改	
constitute	[ˈkɔnstitju:t]	vt.	 组成，构成，形成；设立，建立，任命	
dump	[dʌmp]	n.	 垃圾场	
assurance	[əˈʃuərəns]	n.	 保证，担保；确信，断言；信心，信念	
girl	[ɡə:l]	n.	 少女，姑娘，女孩；女职员	
near	[niə]	adv.	 接近	
freight	[freit]	n.	 货物，货运，运费	
monarch	[ˈmɔnək]	n.	 帝王，君主，最高统治者	
cupboard	[ˈkʌbəd]	n.	 碗柜，小橱	
Tuesday	[ˈtju:zdi]	n.	 星期二	
diploma	[diˈpləumə]	n.	 毕业文凭，学位证书	
progressive	[prəˈɡresiv]	adj.	 进步的，先进的；前进的	
cover	[ˈkʌvə]	n.	 盖子，套子；（书的）封面	
promote	[prəˈməut]	v.	 促进，发扬；提升，提拔；增进，助长	
effective	[iˈfektiv]	adj.	 有效的，生效的；给人深刻印象	
viewpoint	[ˈvju:pɔint]	n.	 观点	
withhold	[ˈwiðhəud]	vi.	 忍住	
solemn	[ˈsɔləm]	adj.	 庄严的，隆重的；严肃的	
equivalent	[iˈkwivələnt]	n.	 相等物，等价物	
rag	[ræɡ]	n.	 抹布，破布，碎布	
artificial	[ˌɑ:tiˈfiʃəl]	adj.	 人工的，人造的，人为的；虚伪的，做作的	
sponsor	[ˈspɔnsə]	v.	 发起，主办；赞助	
seat	[si:t]	v.	 使坐下	
gross	[ɡrəus]	n.	 总额	
communicate	[kəˈmju:nikeit]	v.	 传达，传送；交流；通讯，通话	
game	[ɡeim]	vi.	 赌博	
human	[ˈhju:mən]	n.	 人	
shout	[ʃaut]	n.	 呼喊，叫	
conquest	[ˈkɔŋkwest]	n.	 征服，征服地，掠取物	
glitter	[ˈɡlitə]	v.	 闪闪发光；闪耀	
incidence	[ˈinsidəns]	n.	 影响程度，影响范围；发生率	
presumably	[prɪˈzjuːməbli]	adv.	 推测起来，大概	
irrigate	[ˈɪrɪˌgeɪt]	vi.	 进行灌溉	
cashier	[kæˈʃiə]	n.	 收银员，出纳员	
consumption	[kənˈsʌmpʃən]	n.	 消费（量），消耗	
magazine	[ˌmæɡəˈzi:n]	n.	 杂志，期刊	
gravity	[ˈɡræviti]	n.	 重力，引力；严肃，庄重	
our	[ˈauə]	pron.	 [we的所有格]我们的	
shepherd	[ˈʃepəd]	n.	 牧民，牧羊人；牧师；指导者	
tough	[tʌf]	adj.	 坚韧的，棘手的；强健的，吃苦耐劳的；粗暴的	
wonderful	[ˈwʌndəful]	adj.	 惊人的，奇妙的；极好的；精彩的	
needle	[ˈni:dl]	n.	 针，指针，针状物	
allege	[əˈledʒ]	v.	 断言，宣称；指控	
balloon	[bəˈlu:n]	v.	 乘坐气球；膨胀，激增	
snow	[snəu]	vi.	 下雪；如雪一般地落下	
inspire	[inˈspaiə]	vt.	 鼓舞，激起；使产生灵感	
shall	[ʃæl]	v.	 （我，我们）将要，会；必须，应该	
missionary	[ˈmiʃənəri]	n.	 传教士	
setback	[ˈsetbæk]	n.	 挫折；失效；复发；倒退	
avert	[əˈvə:t]	v.	 防止，避免；转移（目光、注意力等）	
civilize	[ˈsivilaiz]	v.	 （civilise）使文明，开化	
sport	[spɔ:t]	vi.	 开玩笑；玩耍	
howl	[haul]	vi.	 （风等）怒吼，咆哮	
detach	[diˈtætʃ]	vt.	 分开，分离，分遣，派遣（军队）	
yourself	[jɔ:ˈself]	pron.	 [反身代词]你自己；你亲自	
receipt	[riˈsi:t]	n.	 收据，收条；收到，接到	
comprehension	[ˌkɔmpriˈhenʃən]	adj.	 理解（力），领悟；包含，包含力	
wicked	[ˈwikid]	adj.	 坏的；邪恶的；不道德的；淘气的	
vicinity	[viˈsiniti]	n.	 邻近，附近	
thumb	[θʌm]	v.	 示意要求搭车；迅速翻阅	
reasonable	[ˈri:zənəbl]	adj.	 合理的，有道理的；通情达理的；适度的	
moderate	[ˈmɔdərit]	adj.	 有节制的，中等的，适度的，温和的，稳健的	
main	[mein]	n.	 总管道；干线	
potato	[pəˈteitəu]	n.	 马铃薯，土豆	
very	[ˈveri]	adj.	 正是的；真正，真实的	
tend	[tend]	v.	 趋向，往往是；照料，看护	
occupation	[ˌɔkjuˈpeiʃən]	n.	 占领，占据；占用；职业，工作	
nucleus	[ˈnju:kliəs]	n.	nuclei）核，核心，原子核	
question	[ˈkwestʃən]	v.	 询问；怀疑，对…表示疑问	
fridge	[fridʒ]	n.	 （refrigerator的略语）冰箱	
paw	[pɔ:]	n.	 爪	
quit	[kwit]	v.	 离开，退出；停止，放弃，辞职	
close	[kləuz]	adj.	 近的（地）；紧密的（地）	
notable	[ˈnəutəbl]	n.	 值得注意的，显著的，著名的	
gallop	[ˈɡæləp]	v.	 奔驰，飞奔	
alternate	[ˈɔːltə(r)neɪt]	v.	 （使）交替，（使）轮流	
shortly	[ˈʃɔ:tli]	adv.	 立刻，不久；不耐烦地，简慢地	
happy	[ˈhæpi]	adj.	 快乐的，幸福的；乐意的；令人满意的	
collapse	[kəˈlæps]	v.	 倒塌；崩溃；（价格）暴跌；倒闭，破产	
derive	[diˈraiv]	v.	 取得；导出；引申；来自；源自；出自	
injure	[ˈindʒə]	v.	 损害，损伤，伤害	
expectation	[ˌekspekˈteiʃən]	n.	 预期，期望，指望	
trifle	[ˈtraifl]	v.	 玩弄；嬉耍；忽视	
quantify	[ˈkwɔntifai]	v.	 确定数量	
benign	[biˈnain]	adj.	 （病）良性的，（气候）良好的，仁慈的，和蔼的	
beam	[bi:m]	v.	 微笑；播送；以梁支撑	
spicy	[ˈspaɪsi:]	adj.	 加很多香料的；辛辣的；浓郁的	
inspect	[inˈspekt]	vt.	 检查，调查，视察	
dew	[dju:]	n.	 露水	
wink	[wiŋk]	n.	 眨眼；小睡，打盹	
yet	[jet]	conj.	 然而	
princess	[prinˈses]	n.	 公主，王妃	
out	[aut]	adj.	 外面的，往外去的	
defence	[diˈfens]	n.	 （defense）防御，保卫；防务工事；辩护	
brow	[brau]	n.	 眉（毛）；额	
stocking	[ˈstɔkiŋ]	n.	 长（统）袜	
beard	[biəd]	n.	 胡须	
library	[ˈlaibrəri]	n.	 图书馆；藏书室；藏书，丛书，文库	
insure	[inˈʃuə]	vt.	 给…保险；使采取预防措施	
harmony	[ˈhɑ:məni]	n.	 协调，和谐；融洽	
month	[mʌnθ]	n.	 月，月份	
concrete	[ˈkɔnkri:t]	v.	 用混凝土修筑	
ignite	[iɡˈnait]	v.	 点火，引燃	
rein	[rein]	v.	 驾驭，控制，统治	
office	[ˈɔfis]	n.	 办公室，办事处；职务，公职；部，局，处	
countryside	[ˈkʌntrisaid]	n.	 乡下，农村	
again	[əˈɡen]	adv.	 再次，另一次；重新；除此，再	
coupon	[ˈku:pɔn]	n.	 票证，赠券，咨询单，订货单，参赛表	
eagle	[ˈi:ɡl]	n.	 鹰	
type	[taip]	v.	 打字	
shampoo	[ʃæmˈpu:]	v.	 洗发，洗头	
argue	[ˈɑ:ɡju:]	vt.	 辩论，论证；说服，劝说	
peach	[pi:tʃ]	n.	 桃，桃树	
chop	[tʃɔp]	n.	 排骨，肉块，公章，旅行护照	
dictionary	[ˈdikʃənəri]	n.	 词典，字典	
suspect	[səˈspekt]	n.	 嫌疑犯	
award	[əˈwɔ:d]	n.	 奖，奖金；裁定书	
quartz	[kwɔ:ts]	n.	 石英	
toll	[təul]	n.	 通行费；牺牲；死伤人数	
astonish	[əsˈtɔniʃ]	vt.	 使惊讶，使吃惊	
complication	[ˌkɔmpliˈkeiʃən]	n.	 复杂，纠纷；并发症	
egg	[eɡ]	n.	 蛋；卵；卵形物	
meanwhile	[ˈmi:nˌhwail]	adv.	 当时，与此同时	
philosopher	[fiˈlɔsəfə]	n.	 哲学家，哲人	
fancy	[ˈfænsi]	adj.	 花式的，奇特的	
sophomore	[ˈsɔfəmɔ:]	n.	 （中学、大学）二年级学生	
probability	[ˌprɔbəˈbiliti]	n.	 可能性，或然性，概率	
alike	[əˈlaik]	adv.	 一样地；同程度地　	
take	[teik]	v.	 拿取；吃；记录；取得；花费；捕获；认为	
sack	[sæk]	v.	 解雇	
crow	[krəu]	v.	 鸡啼，鸣叫	
among	[əˈmʌŋ]	prep.	 在…之中；在一群（组）之中；于…之间	
empire	[ˈempaiə]	n.	 帝国	
inclusive	[inˈklu:siv]	adj.	 包括的，包含的；包容性强的，各种人都有的	
site	[sait]	n.	 位置，场所，地点	
hit	[hit]	n.	 击中；成功而风行一时的事物	
instrument	[ˈinstrumənt]	n.	 工具，仪器，器械；乐器	
pie	[pai]	n.	 馅饼	
zinc	[ziŋk]	n.	 锌	
grand	[ɡrænd]	adj.	 盛大的，豪华的；重大的，主要的	
waitress	[ˈweɪtrɪs]	n.	 女侍者，女服务员	
sneak	[sni:k]	vt.	 偷偷地做（或拿、吃）	
discourage	[disˈkʌridʒ]	v.	 使泄气，使失去信心	
leak	[li:k]	n.	 漏洞，漏隙；泄漏，漏出	
concerning	[kənˈsə:niŋ]	prep.	 关于，论及	
periodical	[ˌpiəriˈɔdikəl]	adj.	 周期的，定期的	
lofty	[ˈlɔfti]	adj.	 崇高的，高尚的；高傲的；极高的	
proposition	[ˌprɔpəˈziʃən]	n.	 主张，建议；陈述，命题	
manner	[ˈmænə]	n.	 方式；举止；风度，礼貌；规矩；风俗	
sympathy	[ˈsimpəθi]	n.	 同情；赞同，同感；慰问	
chief	[tʃi:f]	n.	 首领，领袖	
fright	[fraɪt]	n.	 恐怖	
energetic	[ˌenəˈdʒetik]	adj.	 精力旺盛的；积极的；有力的	
temperature	[ˈtempəritʃə]	n.	 温度，体温；热度，发烧	
stoop	[stu:p]	n.	 弯腰，曲背	
employee	[ˌemplɔiˈi:]	n.	 雇工，雇员	
reader	[ˈri:də]	n.	 读者；读本，读物；（英国的）大学讲师	
appeal	[əˈpi:l]	n.	 呼吁；申诉；吸引力	
policeman	[pəˈli:smən]	n.	 警察	
responsibility	[riˌspɔnsəˈbiliti]	n.	 责任，责任心；职责，任务	
bacterium	[bækˈtɪəri:əm]	n.	bacteria）细菌	
widow	[ˈwidəu]	n.	 寡妇	
display	[disˈplei]	v.	 陈列，展览，显示（器）	
hang	[hæŋ]	v.	 悬挂，垂吊；吊死，绞死	
attend	[əˈtend]	vi.	 注意；侍奉	
minor	[ˈmainə]	v.	 （in）兼修	
fruitful	[ˈfru:tful]	adj.	 多产的；果实累累的，富有成效的	
trade	[treid]	v.	 经商，交易	
visa	[ˈviːzə]	vt.	 签证	
religious	[riˈlidʒəs]	adj.	 宗教的，信教的，虔诚的	
cloudy	[ˈklaudi]	adj.	 多云的，阴（天）的；混浊的，模糊的	
persevere	[ˌpə:siˈviə]	v.	 坚持，坚忍，不屈不挠	
noon	[nu:n]	n.	 中午，正午	
pure	[pjuə]	adj.	 纯的，纯洁的；纯理论的，抽象的；完全的	
spaceship	[ˈspeɪsˌʃɪp]	n.	 宇宙飞船	
bound	[baund]	n.	 界限；跃起	
foster	[ˈfɒstə(r)]	n.	 养育者	
picture	[ˈpiktʃə]	v.	 画，描述，想象	
warehouse	[ˈwɛəhaus]	n.	 仓库，货栈	
nonsense	[ˈnɔnsəns]	n.	 胡说，废话	
issue	[ˈisju:]	vt.	 发行，发布；流出	
likelihood	[ˈlaiklihud]	n.	 可能性	
stir	[stə:]	v.	 搅拌，搅动；动，摇动；激动；轰动；煽动，鼓动	
bus	[bʌs]	n.	 公共汽车，总线，信息通路	
sailor	[ˈseilə]	n.	 水手，海员	
service	[ˈsɜːvɪs]	v.	 维修，提供服务	
monument	[ˈmɔnjumənt]	n.	 纪念碑，纪念馆，遗迹，不朽的业绩	
deficiency	[diˈfiʃənsi]	n.	 缺乏，不足；缺点，缺陷	
frontier	[ˈfrʌnˌtiə]	n.	 国境，边境；尖端，新领域	
plough	[plau]	v.	 犁，费力地前进	
leaf	[li:f]	n.	 叶子；（书刊的）一页，一张；金属薄片	
company	[ˈkʌmpəni]	n.	 公司；陪伴；宾客；连（队），（一）群，队，伙	
manager	[ˈmænidʒə]	n.	 经理，管理人	
scholar	[ˈskɔlə]	n.	 学者	
value	[ˈvælju]	v.	 评价，估价；尊重	
sociology	[ˌsəusiˈɔlədʒi]	n.	 社会学	
proportion	[prəˈpɔ:ʃən]	n.	 比例；部分；均衡，相称	
tender	[ˈtendə]	v.	 提出，提供；投标	
shipment	[ˈʃipmənt]	n.	 装船，装运；装载的货物，装货量	
November	[nəuˈvembə]	n.	 十一月	
commercial	[kəˈmə:ʃəl]	n.	 广告节目	
pot	[pɔt]	n.	 罐，壶	
parachute	[ˈpærəʃu:t]	v.	 跳伞	
able	[ˈeibl]	adj.	 能够的；有能力的；干练的	
characteristic	[ˌkæriktəˈristik]	n.	 特征，特性	
eccentric	[ikˈsentrik]	n.	 古怪的人	
of	[ɔv]	prep.	 …的；在…之中；用…制的；关于…的	
laptop	[ˈlæpˌtɔp]	n.	 便携式电脑	
cold	[kəuld]	n.	 冷，寒冷；伤风	
lavatory	[ˈlævətəri]	n.	 厕所，盥洗室	
output	[ˈautput]	n.	 产量，输出（量）	
wave	[weiv]	v.	 （挥手）示意，致意	
paragraph	[ˈpærəɡrɑ:f]	n.	 段，节；小新闻，短评	
electricity	[ilekˈtrisiti]	n.	 电，电流；电学	
rim	[rim]	n.	 （圆物的）边，边缘；（眼镜）框	
bring	[briŋ]	v.	 拿来，带来；产生，引起；使处于某种状态	
tone	[təun]	n.	 音调，音色；风气，气氛；语气；色调	
calcium	[ˈkælsiəm]	n.	 钙（化学符号Ca）	
oneself	[wʌnˈself]	pron.	 [反身代词]自己；亲自，本人	
beast	[bi:st]	n.	 兽，牲畜；凶残的人，举止粗鲁的人	
steady	[ˈstedi]	v.	 （使）稳固/稳定	
episode	[ˈepisəud]	n.	 一段情节；片断；（连续剧的）一集	
off	[ɔf]	prep.	 从，从…离开	
competition	[ˌkɔmpiˈtiʃən]	n.	 竞争，比赛；角逐，较量；[总称]竞争者	
screw	[skru:]	v.	 拧，拧紧；扭转，扭歪；旋紧	
lubricate	[ˈlu:brikeit]	v.	 润滑，加润滑油，行贿，收买	
introduce	[ˌɪntrəˈdju:s]	vt.	 介绍；引进，传入；提出（议案等）	
irritate	[ˈiriteit]	vt.	 激怒，恼火，使急躁	
code	[kəud]	n.	 代码，代号，密码；法典，法规，规划	
nylon	['nailɔn]	n.	 尼龙	
flaw	[flɔ:]	v.	 使破裂；使有缺陷	
offset	[ˈɔfset]	v.	 抵消，补偿	
bureau	[ˈbjuərəu]	n.	 署，局，司，处	
transition	[trænˈziʃən]	n.	 转变，变迁，过渡（时期）	
vacation	[vəˈkeiʃən]	n.	 休假，假期	
latitude	[ˈlætitju:d]	n.	 纬度，行动或言论的自由（范围）	
upright	[ˈʌprait]	adv.	 竖立着	
green	[ɡri:n]	n.	 绿色；蔬菜；植物	
await	[əˈweit]	vt.	 等候，期待；（事情等）降临于	
integral	[ˈintiɡrəl]	adj.	 基本的；构成整体所必需的	
square	[skwɛə]	v.	 使成方形；使成二次幂；（使）协调一致	
turbine	[ˈtə:bin]	n.	 汽轮机，涡轮机	
desert	[ˈdezət]	n.	 抛弃，遗弃；擅离，开小差	
drunk	[drʌŋk]	n.	 酗酒者，醉汉	
climax	[ˈklaimæks]	n.	 顶点，高潮	
log	[lɔɡ]	n.	 原木，圆木；航海日志	
vanish	[ˈvæniʃ]	vi.	 突然不见；消失	
outlet	[ˈautlet]	n.	 出路，出口；销路，市场；发泄方法；电源插座	
animal	[ˈæniməl]	adj.	 动物的，野兽的	
absolute	[ˈæbsəlju:t]	adj.	 绝对的，完全的；确实的，肯定的	
tuition	[tjuˈiʃən]	n.	 学费；（某一学科的）教学，讲授，指导	
crew	[kru:]	n.	 全体船员，全体乘务员	
bee	[bi:]	n.	 蜂，蜜蜂；忙碌的人；聚会	
mass	[mæs]	n.	 大量，众多；团，块；群众，民众；质量	
plain	[plein]	n.	 平原，旷野	
threat	[θret]	n.	 恐吓，威胁；坏兆头，危险迹象	
instant	[ˈinstənt]	n.	 瞬间，时刻	
assassinate	[əˈsæsəˌneɪt]	vt.	 暗杀，行刺；中伤	
mortal	[ˈmɔ:təl]	n.	 凡人	
farewell	[ˈfɛəˈwel]	n.	 告别	
debt	[det]	n.	 债，债务	
Monday	[ˈmʌndi]	n.	 星期一	
foam	[fəum]	v.	 泡沫，起泡沫	
profile	[ˈprəufail]	n.	 侧面（像）；轮廓，外形；人物简介	
scramble	[ˈskræmbl]	vi.	 （快速地）爬，攀登；互相争夺，争先	
comedy	[ˈkɔmidi]	n.	 喜剧；喜剧性事件	
courage	[ˈkʌridʒ]	n.	 勇气，胆量	
mechanism	[ˈmekənizəm]	n.	 机械装置，机构；机制	
enthusiasm	[inˈθju:ziæzəm]	n.	 热情，热心；狂热；积极性	
once	[wʌns]	n.	 一次	
empirical	[emˈpirikəl]	adj.	 凭经验（或观察）的，经验主义的	
architect	[ˈɑ:kitekt]	n.	 建筑师；设计师；缔造者；创造者	
barren	[ˈbærən]	adj.	 贫瘠的；不育的；（植物）不结果的；无用的	
orphan	[ˈɔ:fən]	n.	 孤儿	
signal	[ˈsiɡnəl]	v.	 发信号，用信号通知	
nation	[ˈneiʃən]	n.	 民族，国家	
hour	[ˈauə]	n.	 小时，钟点；时刻；课时，工作时间	
particular	[pəˈtikjulə]	n.	 详情，细节，特色	
optical	[ˈɔptikəl]	adj.	 眼的，视力的；光学的	
desire	[	v.	 愿望，欲望，要求	
pastime	[ˈpɑ:staim]	n.	 消遣，娱乐	
strong	[strɒŋ]	adj.	 强壮的，强大的；强烈的，浓的	
footstep	[ˈfutstep]	n.	 脚步（声），足迹	
stun	[stʌn]	vt.	 使…失去知觉；使目瞪口呆，使吃惊	
circle	[ˈsə:kl]	v.	 环绕，旋转	
rescue	[ˈreskju:]	v.	 营救，援救	
trench	[trentʃ]	n.	 （挖）沟，（挖）战壕	
repression	[riˈpreʃən]	n.	 压抑，压制，镇压	
repeat	[riˈpi:t]	n.	 重复	
prone	[prəun]	adj.	 俯伏的，倾斜的，陡的，有…倾向的	
eclipse	[iˈklips]	n.	 日食，月食	
tremble	[ˈtrembl]	v.	 发抖，颤抖；摇动；焦虑	
formation	[fɔ:ˈmeiʃən]	n.	 形成；构成；组织；构造；编制；塑造	
stale	[steil]	n.	 变质的，不新鲜的；陈旧的，陈腐的	
death	[deθ]	n.	 死，死亡；灭亡，毁灭，死因	
finish	[ˈfiniʃ]	v.	 完成；结束；用完；毁掉	
honor	[ˈɔnə]	v.	 尊敬；尊重	
panic	[ˈpænik]	vt.	 使惊慌，使害怕	
real	[riəl]	adj.	 真的，真实的；实际的，现实的	
satire	[ˈsætaiə]	n.	 讽刺，讽刺文学，讽刺作品	
remember	[riˈmembə]	v.	 记住；（to）转达问候，代…致意，代…问好	
paradox	[ˈpærədɔks]	n.	 似非而是的话，自相矛盾的话，反论	
ten	[ten]	pron.	 十（个，只…）	
compare	[kəmˈpɛə]	vi.	 相比	
ring	[riŋ]	v.	 按（铃），敲（钟）	
lounge	[laundʒ]	n.	 休息室，起居室，客厅	
Christian	[ˈkristʃən]	adj.	 基督教徒的	
challenge	[ˈtʃælindʒ]	v.	 向…挑战	
we	[wi]	pron.	 我们<主格>	
bark	[bɑ:k]	n.	 吠声，叫声；树皮	
it	[it]	pron.	 它（作无人称动词的主语）	
listen	[ˈlisn]	vi.	 倾听，留神听，听从	
patent	[ˈpeitənt]	v.	 批准专利	
carbon	[ˈkɑ:bən]	n.	 碳；复写纸	
movie	[ˈmu:vi]	n.	 电影，电影院	
installation	[ˌɪnstəˈleiʃən]	n.	 安装，设置；装置，设施	
prejudice	[ˈpredʒudis]	v.	 使抱偏见，损害	
staple	[ˈsteipl]	n.	 主要产品；名产；纤维；主要成分，主食	
invert	[inˈvə:t]	v.	 使反向；使倒置；使颠倒	
buffet	[ˈbʌfit]	n.	 自助餐	
report	[riˈpɔ:t]	n.	 报告，汇报；传说，传阅	
alive	[əˈlaiv]	adj.	 活着的；存在的；活跃的；（to）敏感的	
quantity	[ˈkwɔntiti]	n.	 量，数量；大量	
pepper	[ˈpepə]	n.	 胡椒粉，胡椒；辣椒	
slot	[slɔt]	vt.	 放入狭缝中；把…纳入	
responsible	[	adj.	 （for，to）应负责的；可靠的；责任重大的	
underlie	[ˌʌndəˈlai]	vt.	 位于…之下，成为…的基础	
artery	[ˈɑ:təri]	n.	 动脉；干线，要道	
official	[əˈfiʃəl]	adj.	 官方的，官方的，正式的	
name	[neim]	vt.	 给…取名；列举；提名	
contribution	[ˌkɔntriˈbju:ʃən]	n.	 贡献；捐款，捐献物；投稿	
ecology	[iˈkɔlədʒi]	n.	 生态学	
senator	[ˈsenətə]	n.	 参议员	
henceforth	[ˈhensˈfɔ:θ]	adv.	 今后	
pull	[	n.	 拉，拖；拉力，牵引力	
jet	[dʒet]	v.	 喷出，喷射	
usage	[ˈju:zidʒ]	n.	 使用，用法；习惯，习俗；惯用法	
hint	[hint]	v.	 暗示，示意	
bicycle	[ˈbaisikl]	vi.	 骑自行车	
thereby	[ˈðɛəbai]	adv.	 因此，从而	
specialize	[ˈspeʃəlaiz]	v.	 （in）专攻，专门研究，专业化	
director	[diˈrektə]	n.	 指导者，主任，导演	
superficial	[ˌsju:pəˈfiʃəl]	adj.	 表面的；肤浅的，浅薄的	
bullet	[ˈbulit]	n.	 子弹，枪弹	
nurse	[nə:s]	v.	 护理，看护	
engine	[ˈendʒin]	n.	 发动机，引擎；火车头	
fence	[fens]	v.	 用篱笆瓦围住；击剑	
faithful	[ˈfeiθful]	adj.	 守信的，忠实的，如实的，可靠的	
discuss	[disˈkʌs]	vt.	 讨论，商议	
safe	[seif]	n.	 保险箱	
kindness	[ˈkaindnis]	n.	 仁慈，亲切；好意；友好行为	
vital	[ˈvaitəl]	adj.	 生死攸关的，重大的；生命的，生机的	
overturn	[ˌəuvəˈtə:n]	v.	 打翻，推翻，颠倒，翻倒	
enter	[ˈentə]	vi.	 进去，进来	
shake	[ʃeik]	n.	 摇动，摇；颤抖，震动	
encyclopedia	[enˌsaikləuˈpi:djə]	n.	 （encyclopaedia）百科全书	
decisive	[diˈsaisiv]	adj.	 决定性的	
abundant	[əˈbʌndənt]	adj.	 大量（充足）的；（in）丰富（富裕）的	
hay	[hei]	n.	 干草	
baby	[ˈbeibi]	adj.	 婴儿似的	
alien	[ˈeiljən]	adj.	 外国的；相异的	
knit	[nit]	v.	 编织；使紧密结合；使严密	
outbreak	[ˈautbreik]	n.	 （战争，愤怒，火灾等的）爆发，（疾病的）发作	
veteran	[ˈvetərən]	n.	 老手，老兵	
plead	[pli:d]	v.	 恳求，请求；为…辩护；提出…为理由	
dine	[dain]	v.	 吃饭，进餐	
mail	[meil]	v.	 邮寄	
confer	[kənˈfə:]	v.	 商讨；授予，颁给（勋衔，学位等）	
quench	[kwentʃ]	v.	 熄灭，扑灭，压制，抑制，止渴	
manifest	[ˈmænifest]	adj.	 明白的，明了的	
herd	[hə:d]	v.	 放牧，群集	
versatile	[ˈvə:sətail]	adj.	 通用的；多才多艺的，多方面的	
barrier	[ˈbæriə]	n.	 栅栏，屏障；障碍（物）	
cattle	[ˈkætl]	n.	 牛；牲口，家畜	
nurture	[ˈnə:tʃə]	n.	 营养品；养育，培育	
land	[lænd]	v.	 （使）靠岸（登陆，降落）	
interfere	[ˌɪntəˈfiə]	v.	 （in）干涉，干预；（with）妨碍，打扰	
hook	[huk]	v.	 钩住	
advise	[ədˈvaiz]	vt.	 忠告，劝告，建议；通知，告知	
embarrass	[imˈbærəs]	vt.	 使困窘，使局促不安；阻碍，麻烦	
other	[ˈʌðə(r]	n.	 另一个人（或事）	
crush	[krʌʃ]	v.	 压服，压垮；压碎，压坏	
entrepreneur	[ˌɔntrəprəˈnə:]	n.	 [法]企业家，主办人	
whistle	[ˈhwisl]	v.	 吹口哨；鸣笛	
president	[ˈprezidənt]	n.	 总统，校长，会长，主席	
conceive	[kənˈsi:v]	v.	 （of）设想，构思，想象；以为；怀胎，怀有	
tablet	[ˈtæblit]	n.	 药片；碑，匾	
every	[ˈevri]	adj.	 每一个的，每个的；每隔…的；全部的	
maiden	[ˈmeidn]	adj.	 未婚的，纯洁的，无经验的	
military	[ˈmilitəri]	adj.	 军事的，军用的，军队的	
elder	[ˈeldə]	n.	 长辈	
otherwise	[ˈʌðəwaiz]	conj.	 要不然	
fog	[fɔɡ]	v.	 以雾笼罩，被雾笼罩；（使）变模糊	
oar	[ɔ:]	v.	 划，划动，划行	
concede	[kənˈsi:d]	vt.	 承认；容许；（比赛结束前）认输；退让	
limitation	[ˌlimiˈteiʃən]	n.	 限制，局限性	
seaside	[ˈsi:ˌsaɪd]	n.	 海滨，海边	
shatter	[ˈʃætə]	v.	 粉碎；使疲惫；使震骇	
departure	[diˈpɑ:tʃə]	n.	 离开，起程	
cliff	[klif]	n.	 悬崖；峭壁	
aim	[eim]	vt.	 把…瞄准	
decision	[diˈsiʒən]	n.	 决定，决心；决议；决策	
calorie	[ˈkæləri]	n.	 卡路里（食物所产生的热量或能量单位）	
specification	[ˌspesifiˈkeiʃən]	n.	）规格，说明书，规范	
highly	[ˈhaɪli]	adv.	 高度地，很，非常；赞许地	
play	[pleɪ]	n.	 游戏；玩耍；剧本	
depict	[diˈpikt]	v.	 描绘；描写，描述	
rent	[rent]	n.	 租金	
move	[mu:v]	n.	 移动，活动，行动	
enormous	[iˈnɔ:məs]	adj.	 巨大的，庞大的	
endurance	[inˈdjuərəns]	n.	 忍耐（力），持久（力），耐久（性）	
boost	[bu:st]	n.	 提升；增加；抬高（价格）；支援	
enthusiastic	[inˌθju:ziˈæstik]	adj.	 热情的，热心的	
bonus	[ˈbəunəs]	n.	 奖金，红利	
exposure	[iksˈpəuʒə]	n.	 暴露，揭露；（身体）受冻；曝光	
sufficient	[səˈfiʃənt]	adj.	 （for）足够的，充分的（比enough拘谨、正式）	
eminent	[ˈeminənt]	adj.	 显赫的；杰出的；有名的；优良的	
maximum	[ˈmæksiməm]	adj.	 最大的，最高的	
extra	[ˈekstrə]	n.	 附加物，额外的东西	
slap	[slæp]	n.	 拍，掌击	
thank	[θæŋk]	n.	 感谢，谢意	
intelligent	[inˈtelidʒənt]	adj.	 聪颖的；有才智的；有灵性的	
industry	[ˈindəstri]	n.	 工业，产业；勤劳，勤奋	
microphone	[ˈmaikrəfəun]	n.	 话筒，扩音器	
pierce	[piəs]	v.	 剌穿，刺破	
prick	[prik]	n.	 刺伤，刺痛，刺孔	
growth	[ɡrəuθ]	n.	 生长，增长，发展	
twice	[twais]	adv.	 两次，两倍	
bread	[bred]	n.	 面包；食物；营养，营养物	
statistical	[stəˈtɪstɪkəl]	adj.	 统计的，统计学的	
difficult	[ˈdifikəlt]	adj.	 困难的，艰难的	
road	[roʊd	n.	 路，道路，途径	
primitive	[ˈprimitiv]	adj.	 原始的，远古的，早期的；粗糙的，简单的	
tolerant	[ˈtɔlərənt]	adj.	 容忍的，宽容的；有耐药力的	
solar	[ˈsəulə]	adj.	 太阳的，日光的	
dawn	[dɔ:n]	v.	 破晓；开始现出	
sensitive	[ˈsensitiv]	adj.	 （to）敏感的，易受伤害的；灵敏的	
fill	[fil]	v.	 （with）填满，充满	
trial	[ˈtraiəl]	n.	 讯问，审讯；试验；试用；尝试	
experiment	[iksˈperimənt]	v.	 （on）进行实验；做试验	
horror	[ˈhɔrə]	n.	 恐怖，战栗	
beach	[bi:tʃ]	n.	 海滩，湖滩，河滩	
keyboard	[ˈki:bɔ:d]	vt.	 用键盘输入（信息）	
quick	[kwik]	adv.	 快，迅速地	
fur	[fə:]	n.	 毛，毛皮	
magnify	[ˈmæɡnifai]	vt.	 放大，扩大，夸大，夸张	
mysterious	[miˈstiəriəs]	adj.	 神秘的，可疑的，难理解的	
shot	[ʃɔt]	n.	 开枪，射击；投篮；弹丸，炮弹，子弹	
infrared	[ˈinfrəˈred]	adj.	 （辐射）红外线的；对红外辐射敏感的	
Saturday	[ˈsætədi]	n.	 星期六	
mild	[maild]	adj.	 温和的，轻微的，味淡的，不含有害物质的	
replacement	[riˈpleismənt]	n.	 取代，替换，替换物，代替物	
twenty	[ˈtwenti:]	pron.	 二十（个，只…）	
potential	[pəˈtenʃəl]	n.	 潜能，潜力	
charity	[ˈtʃæriti]	n.	 慈善（团体），仁慈，施舍	
scent	[sent]	v.	 嗅，发觉；使充满香味；洒香水于	
complex	[ˈkɔmpleks]	n.	 联合体	
intrigue	[inˈtri:ɡ]	v.	 密谋，私通；激起…的兴趣；以诡计取得	
person	[ˈpɜːsn]	n.	 人，喜欢（或适应）…的人；人物；人称	
definition	[ˌdefiˈniʃən]	n.	 定义，解释；（轮廓影像等的）清晰度；阐明	
fountain	[ˈfauntin]	n.	 泉水，喷泉，源泉	
merge	[mə:dʒ]	v.	 （使）结合，（使）合并，（使）合为一体	
topic	[ˈtɔpik]	n.	 话题，主题，题目	
idea	[aiˈdiə]	n.	 想法，念头；概念，观念；意见，主意	
compensate	[ˈkɔmpenseit]	v.	 （for）补偿，赔偿	
applicable	[ˈæplikəbl]	adj.	 可应用（实施）的；适当的，合适的	
risk	[risk]	n.	 冒险；风险	
only	[ˈəunli]	conj.	 可是，不过	
cash	[kæʃ]	v.	 兑现，付（或收）现款	
delegate	[ˈdeliɡit]	vt.	 委派…为代表；授权；委托	
limited	[ˈlimitid]	adj.	 有限的，被限制的	
stem	[stem]	vi.	 起源于，由…造成	
terror	[ˈterə]	n.	 恐怖；可怕的人（事）	
jealous	[ˈdʒeləs]	adj.	 妒忌的；小心守护的	
resource	[riˈsɔ:s]	n.	 资源，财力；办法，智谋；应变之才	
sour	[ˈsauə]	adj.	 酸的；酸痛的；脾气坏的；刻薄的	
fun	[fʌn]	n.	 玩笑，娱乐；有趣的人（或事物）	
cherry	[ˈtʃeri:]	n.	 樱桃（树）	
call	[kɔ:l]	n.	 叫；号召	
fast	[fɑ:st]	adv.	 紧紧地；迅速地	
cart	[kɑ:t]	n.	 （二轮货运）马车，手推车；小型机动车	
dealer	[ˈdi:lə]	n.	 商人	
ban	[bæn]	n.	 禁止，禁令	
cartoon	[kɑ:ˈtu:n]	n.	 漫画，幽默画；动画片	
sample	[ˈsɑ:mpl]	v.	 取样，采样	
concise	[kənˈsais]	adj.	 简明的，简洁的	
despise	[disˈpaiz]	v.	 轻视，蔑视	
storm	[stɔ:m]	v.	 猛攻，直捣	
indicate	[ˈindikeit]	v.	 指出，指示；表明，暗示	
coat	[kəut]	v.	 涂（盖）上	
notify	[ˈnəutifai]	v.	 通知，告知，报告	
hasty	[ˈheisti]	adj.	 匆忙的，仓促的；草率的	
grim	[ɡrim]	adj.	 严酷的，令人害怕的；不愉快的，讨厌的	
cake	[keik]	n.	 饼，糕，蛋糕；扁平的块状物	
background	[ˈbækɡraund]	n.	 背景，经历；幕后	
sphere	[sfiə]	n.	 球，球体；范围，领域	
favorite	[ˈfeivərit]	adj.	 喜爱的	
peculiar	[piˈkju:ljə]	adj.	 古怪的，异常的；特殊的，特有的	
marine	[məˈri:n]	adj.	 海的，海生的；船舶的，航海的	
coarse	[kɔ:s]	adj.	 粗糙的；粗鲁的，粗俗的	
pump	[pʌmp]	v.	 用（泵）抽（水）；打气，泵送	
contrive	[kənˈtraiv]	vt.	 谋划，策划；设法做到；设计，想出	
literally	[ˈlitərəli]	adv.	 照字面意义，逐字地；确实	
articulate	[ɑ:ˈtikjulit]	v.	 清楚地讲话	
satisfaction	[ˌsætisˈfækʃən]	n.	 满足，满意；乐事，愉快	
drop	[drɔp]	v.	 落下；下降；失落	
edition	[iˈdiʃən]	n.	 版，版本，版次	
highland	[ˈhaɪlənd]	n.	 高地，高原	
forever	[fəˈrevə]	adv.	 （forever）永远；总是	
watch	[wɔtʃ]	n.	 看管；表	
bizarre	[biˈzɑ:]	adj.	 异乎寻常的，稀奇古怪的	
sculpture	[ˈskʌlptʃə]	n.	 雕刻（术），雕塑（术）；雕刻作品	
champagne	[ʃæmˈpein]	n.	 香槟酒；微黄色，香槟酒色	
offensive	[əˈfensiv]	n.	 攻势，进攻	
consist	[kənˈsist]	v.	 （in）在于，存在于；（of）由…组成，由…构成	
harassment	['hærəsmənt]	n.	 骚扰，扰乱；烦恼，烦乱	
acclaim	[əˈkleim]	n.	 欢呼，喝彩，称赞	
nationality	[ˌnæʃəˈnæliti]	n.	 国籍，民族	
skyscraper	[ˈskaiˌskreipə]	n.	 摩天大楼	
dirt	[də:t]	n.	 污物，污垢	
incorporate	[inˈkɔ:pəreit]	adj.	 合并的	
till	[til]	prep.	 直到，直到…为止	
choice	[tʃɔis]	adj.	 精选的	
counterpart	[ˈkauntəpɑ:t]	n.	 对应的人（或物）	
imperative	[imˈperətiv]	adj.	 强制的；紧急的	
region	[ˈri:dʒən]	n.	 地区，地带，行政区，（科学等）领域	
ray	[rei]	n.	 光线，射线	
novel	[ˈnɔvəl]	adj.	 新奇的，新颖的	
expel	[iksˈpel]	v.	 把…开除；驱逐；排出；发射	
ride	[raid]	v.	 骑，乘	
vessel	[ˈvesəl]	n.	 器皿；船，舰；血管	
inhabitant	[inˈhæbitənt]	n.	 居民，住户	
wooden	[ˈwudn]	adj.	 木制的；呆笨的	
someone	[ˈsʌmwʌn]	pron.	 某人（=somebody）	
pedestrian	[piˈdestriən]	adj.	 徒步的，呆板的，通俗的	
fearful	[ˈfiəful]	adj.	 可怕的，吓人的；害怕，担心，惊恐	
bush	[buʃ]	n.	 灌木（丛）	
lumber	[ˈlʌmbə]	n.	 木材，木料	
sting	[stiŋ]	v.	 刺，刺痛，剧痛；刺，叮	
parcel	[ˈpɑ:səl]	v.	 打包，捆扎，分配	
zoom	[zu:m]	n.	 陡升；嗡嗡声	
confess	[kənˈfes]	v.	 供认，承认，坦白，忏悔	
physiological	[ˌfiziəˈlɔdʒikəl]	adj.	 生理学的，生理学上的	
activity	[ækˈtiviti]	n.	 活动；活力；能动性	
constant	[ˈkɔnstənt]	n.	 常数，恒量	
source	[sɔ:s]	n.	 源，源泉；来源，出处	
weld	[weld]	n.	 焊接，焊缝	
nobody	[ˈnəubədi]	n.	 小人物	
population	[ˌpɔpjuˈleiʃən]	n.	 人口，（全体）居民	
soup	[su:p]	n.	 汤	
curiosity	[ˌkjuəriˈɔsiti]	n.	 好奇心；古董，古玩	
education	[ˌedju:ˈkeiʃən]	n.	 教育，培养，训练	
sticky	[ˈstiki]	adj.	 粘的，粘性的；棘手的；（道路）泥泞的	
classify	[ˈklæsifai]	v.	 分类，分等（级）	
lottery	[ˈlɔtəri]	n.	 抽彩；碰运气的事，难于算计的事	
affect	[əˈfekt]	n.	 情感，感情	
intervene	[ˌɪntəˈvi:n]	v.	 （in）干涉，干预；插入，介入	
behalf	[biˈhɑ:f]	n.	 利益	
collide	[kəˈlaid]	vi.	 [with]互撞，碰撞；冲突，抵触	
unlike	[ˌʌnˈlaik]	prep.	 不像，和…不同	
borrow	[ˈbɒrəʊ]	vt.	 借，借入；（思想、文字等）采用，抄袭	
hijack	[ˈhaidʒæk]	v.	 劫持，劫机，拦路抢劫	
flock	[flɒk]	v.	 群集，成群	
labor	[ˈleibə]	v.	 劳动，苦干	
gas	[ɡæs]	vt.	 毒（死）；加油	
mob	[mɔb]	vi.	 围攻，聚众闹事	
purpose	[ˈpə:pəs]	n.	 目的，意图；用途，效果	
voice	[vɔis]	n.	 声音；嗓音；意见；语态	
leaflet	[ˈli:flit]	n.	 小叶，嫩叶；传单，活页	
removal	[riˈmu:vəl]	n.	 移动，迁居；除去	
survive	[səˈvaiv]	v.	 幸免于，幸存；比…长命	
historical	[hisˈtɔrikəl]	adj.	 历史的；有关历史的	
nervous	[ˈnə:vəs]	adj.	 神经的；神经过敏的，紧张不安的	
salvation	[sælˈveiʃən]	n.	 拯救，救助；救济（者，品）；救世主	
poet	[ˈpəuit]	n.	 诗人	
wrong	[rɔŋ]	v.	 委屈	
danger	[ˈdeindʒə]	n.	 危险；威胁；危险事物	
emotion	[iˈməuʃən]	n.	 情绪，情感，感情	
average	[ˈævəridʒ]	v.	 平均	
glamor	['glæmə]	v.	 迷惑	
jury	[ˈdʒuəri]	n.	 陪审团；全体评审员	
cube	[kju:b]	n.	 立方形，立方体；立方，三次幂	
laser	[ˈleizə]	n.	 激光	
beautiful	[ˈbju:təful]	adj.	 美的，美丽的；出色的，完美的	
hinge	[hindʒ]	vi.	 依…而定	
neat	[ni:t]	adj.	 整洁的，干净的，优美的，精致的	
fund	[fʌnd]	n.	 资金，基金；存款，现款；（知识等的）累积	
outlook	[ˈautluk]	n.	 景色，风光；观点，见解；展望，前景	
workshop	[ˈwə:kʃɔp]	n.	 车间，工场，修理厂；研讨会，讲习班	
hop	[hɔp]	n.	 蹦跳；短程飞行	
outdoor	[ˈautdɔ:]	adj.	 室外的，野外的	
parliament	[ˈpɑ:ləmənt]	n.	 国会，议会	
mine	[main]	v.	 采矿	
brandy	[ˈbrændi]	n.	 白兰地酒	
rude	[ru:d]	adj.	 粗鲁的；猛烈的，残暴的；粗糙的，粗陋的	
gradual	[ˈɡrædjuəl]	adj.	 逐渐的，逐步的	
administer	[ədˈministə]	v.	 施行，执行；掌管，料理…的事务；给予	
struggle	[ˈstrʌɡl]	n.	 斗争，奋斗，努力	
recognition	[ˌrekəɡˈniʃən]	n.	 认出，辨认；承认	
vast	[vɑ:st]	adj.	 巨大的，辽阔的，大量的；巨额的	
guy	[ɡaɪ]	n.	 家伙，男人，伙计	
lease	[li:s]	n.	 租借，租期，租赁物	
humorous	[ˈhju:mərəs]	adj.	 富于幽默感的，幽默的；滑稽的	
noun	[naun]	n.	 名词	
typewriter	[ˈtaipˌraitə]	n.	 打字机	
summit	[ˈsʌmit]	n.	 顶，最高点；颠峰，高峰；最高级会议	
prevalent	[ˈprevələnt]	adj.	 流行的，普遍的	
sniff	[snif]	vi.	 嗅…味道；抽鼻涕；对嗤之以鼻，蔑视	
characterize	[ˈkæriktəraiz]	v.	 （characterise）表示…的特性；描述…特性	
ache	[eik]	n.	 （指连续）疼痛、酸痛	
exhaust	[iɡˈzɔ:st]	n.	 排气装置；废气	
young	[jʌŋ]	n.	 青年人	
brim	[brim]	n.	 边缘，帽沿	
tired	[ˈtaiəd]	adj.	 疲劳的；厌倦的	
fossil	[ˈfɔsl]	n.	 化石	
arm	[ɑ:m]	v.	 武装；配备	
roundabout	[ˈraundəbaut]	n.	 环状交叉路口	
comparative	[kəmˈpærətiv]	adj.	 比较的，相当的	
detector	[dɪˈtektə]	n.	 发现者，侦察器，探测器，检波器，检电器	
colleague	[ˈkɔli:ɡ]	n.	 同事，同僚	
eve	[iːv]	n.	 （节日等的）前夜，前夕	
creep	[kri:p]	v.	 爬，爬行；（植物）蔓延	
stamp	[stæmp]	v.	 跺脚，顿足；盖章	
supersonic	[ˌsju:pəˈsɔnik]	n.	 超声波，超声频	
block	[blɔk]	v.	 阻塞，拦阻	
loyal	[ˈlɔiəl]	adj.	 （to）忠诚的，忠贞的	
textile	[ˈtekstail]	adj.	 纺织的	
miracle	[ˈmirəkl]	n.	 奇迹，令人惊奇的人（或事）	
something	[ˈsʌmθiŋ]	pron.	 某事，某物；被视为有意义的事物	
cardinal	[ˈkɑ:dinl]	adj.	 首要的，基本的	
damn	[dæm]	adv.	 极	
pine	[pain]	n.	 松树	
scorn	[skɔ:n]	v.	 轻蔑，藐视	
biology	[baiˈɔlədʒi]	n.	 生物学	
handbook	[ˈhændbuk]	n.	 手册，指南	
illiterate	[ɪˈlɪtərɪt]	adj.	 文盲的，未受教育的	
purify	[ˈpjuərifai]	v.	 使纯净，提纯	
album	[ˈælbəm]	n.	 唱片；集邮册，相册	
literacy	[ˈlitərəsi]	n.	 有文化，有教养，有读写能力	
level	[ˈlevl]	adj.	 水平的	
correspondence	[ˌkɔrisˈpɔndəns]	n.	 通信，信件；（with）符合；（to）相当于，对应	
stationary	[ˈsteiʃənəri]	adj.	 静止的，固定的	
skull	[skʌl]	n.	 头盖骨，颅骨	
impart	[imˈpɑ:t]	vt.	 传授，给予；告知，通知	
noticeable	[ˈnəutisəbl]	adj.	 显而易见的，值得注意的，重要的	
compose	[kəmˈpəuz]	v.	 组成，构成；（of）由…组成；创作（诗歌等）	
intimidate	[inˈtimideit]	vt.	 恫吓；恐吓；威胁	
collision	[kəˈliʒən]	n.	 碰撞；（利益，意见等的）冲突，抵触	
merely	[ˈmiəli]	adv.	 仅仅，只不过	
space	[	v.	 留间隔，隔开	
blueprint	[ˈblu:ˈprint]	vt.	 制成蓝图，计划	
convey	[kənˈvei]	v.	 传达，表达；运送，输送，转运；传播	
logical	[ˈlɔdʒikəl]	adj.	 逻辑的，符合逻辑的	
sunset	[ˈsʌnset]	n.	 日落，傍晚；晚霞	
hospital	[ˈhɔspitəl]	n.	 医院	
highway	[ˈhaiwei]	n.	 公路，大路	
uncover	[ˌʌnˈkʌvə]	v.	 揭开，揭露	
cylinder	[ˈsilində]	n.	 圆筒，圆锥体；汽缸	
silk	[silk]	n.	 丝，绸	
upon	[əˈpɔn]	prep.	 在…上；在…旁[=on]	
determine	[diˈtə:min]	v.	 决心，决定；确定，限定	
nickname	[ˈnikneim]	vt.	 给…起绰号	
corrupt	[kəˈrʌpt]	adj.	 腐败的，贪污的	
also	[ˈɔ:lsəu]	adv.	 而且（也），此外（还）；同样地	
loud	[laud]	adj.	 大声的，响亮的；吵闹的，喧嚣的	
him	[him]	pron.	 他（he的宾格形式）	
desolate	[ˈdesəlit]	v.	 使荒芜；使凄凉，使孤单	
executive	[iɡˈzekjutiv]	adj.	 执行的，实施的	
whisky	[ˈhwiski]	n.	 威士忌酒	
nor	[nɔ:]	conj.	 也不，也没有	
society	[səˈsaiəti]	n.	 社会；社团；社交界，上流社会	
harden	[ˈhɑːdn]	v.	 （使）变硬	
vicious	[ˈviʃəs]	adj.	 恶毒的，凶残的，邪恶的	
experience	[iksˈpiəriəns]	n.	 经验；经历；体验；阅历	
barn	[bɑ:n]	n.	 谷仓，仓库	
funny	[ˈfʌni]	adj.	 滑稽的，可笑的	
serial	[ˈsiəriəl]	adj.	 连续的	
complement	[ˈkɔmplimənt]	vt.	 补充，补足	
propel	[prəˈpel]	vt.	 推进，推动；激励，驱使	
suffice	[səˈfais]	vt.	 （食物等）使（某人）满足	
optimum	[ˈɔptiməm]	n.	 最适宜（条件）	
staff	[stɑ:f]	v.	 配备工作人员	
supreme	[sju:ˈpri:m]	adj.	 极度的，最重要的；至高的，最高的	
peninsula	[piˈninsjulə]	n.	 半岛	
leather	[ˈleðə]	n.	 皮革，皮革制品	
case	[keis]	n.	 箱，盒，容器；情况，事实；病例；案件	
prototype	[ˈprəutətaip]	n.	 原型；典型，范例	
orchestra	[ˈɔ:kistrə]	n.	 管弦乐队	
motor	[ˈməutə]	n.	 发动机，电动机	
community	[kəˈmju:niti]	n.	 同一地区的全体居民，社会，社区；共同体	
alphabet	[ˈælfəbit]	n.	 字母表；初步，入门	
gloomy	[ˈɡlu:mi]	adj.	 阴暗的，阴沉的，令人沮丧的，阴郁的	
mammal	[ˈmæməl]	n.	 哺乳动物	
northwest	[nɔ:θˈwest]	adv.	 向西北，在西北	
frog	[frɔɡ]	n.	 蛙	
applaud	[əˈplɔ:d]	vi.	 鼓掌；夸赞；欢呼	
fate	[feit]	n.	 命运	
break	[breik]	n.	 休息时间	
elapse	[iˈlæps]	vi.	 （时间）溜走；（光阴）逝去	
criterion	[kraiˈtiəriən]	n.	criteriaorcriterions标准，尺度	
compassion	[kəmˈpæʃən]	n.	 同情；怜悯（for）	
beginning	[biˈɡiniŋ]	n.	 开始，开端；起源，早期阶段	
statesman	[ˈsteitsmən]	n.	 政治家，国务活动家	
defect	[diˈfekt]	n.	 过失；缺点；不足	
pollution	[pəˈluʃən]	n.	 污染	
charge	[tʃɑ:dʒ]	n.	 费用，代价；电荷	
seek	[si:k]	v.	 （after，for）寻找，探索；试图，企图	
flush	[flʌʃ]	adj.	 洋溢的；富裕的；齐平的	
steel	[sti:l]	n.	 钢	
own	[əun]	adj.	 （用在所有格后面，加强语气）自己的	
clock	[klɔk]	vt.	 记录（时间、速度等），为…计时	
smash	[smæʃ]	v.	 打碎，粉碎	
hamper	[ˈhæmpə]	v.	 妨碍，阻碍，牵制	
weave	[wi:v]	n.	 编织法，编织式样	
behind	[biˈhaind]	prep.	 在…的背后，（遗留）在…后面；落后于	
aerial	[ˈɛəriəl]	n.	 天线	
lightning	[ˈlaitniŋ]	adj.	 闪电般的，快速的	
circus	[ˈsə:kəs]	n.	 马戏团，杂技团；马戏场，杂技场	
realistic	[ˌriəˈlistik]	adj.	 现实（主义）的	
government	[ˈɡʌvənmənt]	n.	 政府，内阁；管理，支配；政治，政体	
longitude	[ˈlɔndʒitju:d]	n.	 经度	
repair	[riˈpɛə]	v.	 补救，纠正；修理	
dive	[daiv]	v.	 潜水，跳水，俯冲	
lick	[lik]	n.	 舔；少量	
rose	[rəuz]	n.	 玫瑰，蔷薇	
flee	[fli:]	v.	 逃走；逃避	
steamer	[ˈsti:mə]	n.	 汽船，轮船	
meadow	[ˈmedəu]	n.	 草地，牧场	
linen	[ˈlinin]	n.	 亚麻布，亚麻布制品	
theory	[ˈθiəri]	n.	 理论，原理；学说，见解，看法	
different	[ˈdifərənt]	adj.	 差异的，差异的，不同的	
gut	[ɡʌt]	vt.	 取出内脏	
chronic	[ˈkrɔnik]	adj.	 慢性的；积习难改的；严重的，坏的	
swim	[swim]	n.	 游泳	
wolf	[wulf]	n.	 狼	
marvelous	[ˈmɑ:vələs]	adj.	 （marvellous）惊人的，非凡的	
recycle	[ˌri:ˈsaikl]	v.	 再循环，重复利用	
May	[mei]	n.	 五月	
gently	[ˈdʒentlɪ]	adv.	 文雅地，有礼貌地；轻轻地	
spear	[spiə]	n.	 矛，枪	
centigrade	[ˈsentiɡreid]	n.	 摄氏温度计（的）；百分度（的）	
constituent	[kənˈstitjuənt]	adj.	 组成的，构成的	
singular	[ˈsiŋɡjulə]	adj.	 非凡的，奇特的，卓越的；单数的	
teach	[ti:tʃ]	vi.	 讲课，当教师	
tell	[tel]	vt.	 告诉，讲述；告诫；吩咐，命令；辨/区别	
objection	[əbˈdʒekʃən]	n.	 （to）反对，异议，不喜欢，反对的理由	
accord	[əˈkɔ:d]	vi.	 符合，一致	
everyday	[ˈevridei]	adj.	 每日的，日常的	
deed	[di:d]	n.	 行为，行动；功绩，事迹；证书；契据	
steward	[stjuəd]	n.	 乘务员，服务员；看管人；膳食管理员	
identification	[aiˌdentifiˈkeiʃən]	n.	 识别，鉴别；证件；认同	
graceful	[ˈɡreisful]	adj.	 优美的，文雅的，大方的	
precision	[priˈsiʒən]	n.	 精确，精确度	
advance	[ədˈvɑ:ns]	vt.	 促进，推进	
infrastructure	[ˈinfrəˌstrʌktʃə]	n.	 基础结构，基础设施	
relax	[riˈlæks]	v.	 （使）松驰，放松	
natural	[ˈnætʃərəl]	adj.	 正常的；自然界的，天然的，天赋的，固有的	
jazz	[dʒæz]	n.	 爵士乐	
participate	[pɑ:ˈtisipeit]	v.	 （in）参与，参加；分享，分担；含有，带有	
strategy	[ˈstrætidʒi]	n.	 战略，策略；对策，政策	
conquer	[ˈkɔŋkə]	v.	 征服，战胜，占领；克服，破除（坏习惯等）	
downward	[ˈdaunwəd]	adv.	 （alsodownwards）向下，往下	
sympathetic	[ˌsimpəˈθetik]	n.	 交感神经	
truck	[trʌk]	n.	 卡车，载重汽车	
press	[pres]	n.	 报刊，通讯社；压榨机	
gate	[ɡeit]	n.	 大门；入口；观众人数，门票收入	
entry	[ˈentri]	n.	 进入，入口；通道；记载，条目	
bride	[braid]	n.	 新娘	
spider	[ˈspaidə]	n.	 蜘蛛	
supper	[ˈsʌpə]	n.	 晚餐	
track	[træk]	v.	 跟踪，追踪	
coward	[ˈkaʊəd]	n.	 懦夫，胆怯者	
prevent	[priˈvent]	v.	 （from）预防，防止，阻止，制止，妨碍	
barrel	[ˈbærəl]	n.	 桶；枪管，炮管	
threshold	[ˈθreʃhəuld]	n.	 门槛；入门，开端	
integrate	[ˈintiɡreit]	v.	 （使）成为一体，（使）结合；（使）合并	
crust	[krʌst]	n.	 外皮，壳；地壳	
profit	[ˈprɔfit]	v.	 （by，from）得利，获益；有利于	
tour	[tuə]	v.	 旅游	
card	[kɑ:d]	n.	 卡片，名片；纸牌；纸片	
careful	[ˈkɛəful]	adj.	 小心的，仔细的；细致的，精心的	
tight	[tait]	adv.	 紧紧地	
documentary	[ˌdɔkjuˈmentəri]	n.	 记录片	
heritage	[ˈheritidʒ]	n.	 遗产，继承物；传统	
slogan	[ˈsləuɡən]	n.	 标语，口号	
wealth	[welθ]	n.	 财富，财产；大量	
context	[ˈkɔntekst]	n.	 （文章等）前后关系；（事件等发生的）背景	
existence	[iɡˈzistəns]	n.	 存在，实在；生存，生活（方式）	
Marxist	[ˈmɑ:ksist]	n.	 马克思主义者	
nuisance	[ˈnju:səns]	n.	 讨厌的人（或东西）；麻烦事	
tobacco	[təˈbækəu]	n.	 烟草，烟叶	
poetry	[ˈpəuitri]	n.	 诗歌，诗集	
describe	[disˈkraib]	v.	 描述，形容	
waste	[weist]	n.	 浪费；废物	
explain	[iksˈplein]	v.	 解释，说明	
remote	[riˈməut]	adj.	 遥远的，疏远的，偏僻的，细微的	
trend	[trend]	vi.	 伸向，倾向	
flight	[flait]	n.	 飞翔，飞行；航班；航程；逃跑；楼梯的一段	
reliable	[riˈlaiəbl]	adj.	 可靠的，可信赖的，确实的	
precede	[ˌpriˈsi:d]	v.	 领先（于），在（…之前）；优先，先于	
outset	[ˈautset]	n.	 开始，开端	
reassure	[ˌri:əˈʃuə]	v.	 使安心，使放心；使消除疑虑	
formal	[	adj.	 正式的；形式的	
whisper	[ˈhwispə]	n.	 耳语；传闻	
mystery	[ˈmistəri]	n.	 神秘，神秘的事物；神秘小说，侦探小说	
remind	[riˈmaind]	v.	 （of）提醒，使想起	
simple	[ˈsimpl]	adj.	 简单的；单纯的；迟钝的	
sort	[sɔ:t]	v.	 分类，整理	
hill	[hil]	n.	 小山，山岗，高地；丘陵（地带）	
overwhelm	[ˌəuvəˈhwelm]	v.	 淹没，覆没，压倒，制服，使不知所措	
joint	[dʒɔint]	adj.	 联合的，共同的，连接的	
now	[nau]	adv.	 现在，如今，目前；当时，于是，然后	
hospitality	[ˌhɔspiˈtæliti]	n.	 好客，殷勤，款待	
costume	[ˈkɔstju:m]	n.	 （流行的）服饰；戏装，（特定场合的）套装	
splash	[splæʃ]	n.	 溅，飞溅声	
reed	[riːd]	n.	 芦苇，苇丛；芦笛，牧笛	
senate	[ˈsenit]	n.	 参议院，上院	
sight	[sait]	n.	 视力；望见，瞥见；视域；眼界；情景，奇观	
economy	[iˈkɔnəmi]	n.	 节约；经济	
water	[ˈwɔ:tə]	vi.	 流泪，加水	
scan	[skæn]	n.	 扫描	
immerse	[iˈmə:s]	v.	 使沉浸在；使浸没	
participant	[pɑ:ˈtisipənt]	adj.	 有份的，参与的	
commerce	[ˈkɔmə:s]	n.	 商业，贸易；交际，交往	
born	[bɔ:n]	adj.	 出生的，产生的；天生的，十足的	
destructive	[disˈtrʌktiv]	adj.	 破坏性	
innocent	[ˈinəsnt]	adj.	 清白的；无罪的；天真的；幼稚的	
slip	[slip]	n.	 疏忽，小错，口误，笔误	
ponder	[ˈpɔndə]	v.	 沉思，考虑	
presently	[ˈprezəntli]	adv.	 一会儿，不久；现在，目前	
southern	[ˈsʌðən]	adj.	 南方的，南部的	
assistant	[əˈsistənt]	n.	 助手，助教；辅助物；店员，售货员	
deduce	[diˈdju:s]	vt.	 （from）演绎，推断，推论	
evil	[ˈi:vəl]	n.	 邪恶，罪恶	
poverty	[ˈpɔvəti]	n.	 贫穷，贫困	
cereal	[ˈsiəriəl]	n.	 谷类植物，谷物；荞麦食品	
dissipate	[ˈdisipeit]	v.	 驱散；（使云、雾、疑虑等）消散；挥霍	
outer	[ˈautə]	adj.	 外部的，外面的，外层的	
captain	[ˈkæptin]	v.	 做…的首领，指挥	
bid	[bid]	n.	 出价，投标	
mouth	[mauθ]	n.	 口，嘴	
telegraph	[ˈtelɪˌgræf]	v.	 打电报，发电报	
humble	[ˈhʌmbl]	v.	 降低，贬低	
contempt	[kənˈtempt]	n.	 轻视，藐视；受辱，丢脸	
reckon	[ˈrekən]	v.	 计算，总计，估计，猜想，依赖	
ago	[əˈɡəu]	adv.	 （常和一般过去时的动词连用）以前，…前	
clasp	[klɑ:sp]	v.	 扣住，钩住；紧握，紧抱	
scholarship	[ˈskɔləʃip]	n.	 奖学金；学问，学识	
federation	[ˌfedəˈreiʃən]	n.	 同盟；联邦；联合；联盟；联合会	
way	[wei]	n.	 道路，路程；方法/式，手段；习惯；状态	
academy	[əˈkædəmi]	n.	 （高等）专科院校；学术社团，协会，研究院	
social	[ˈsəuʃəl]	adj.	 社会的；交际的	
discrepancy	[disˈkrepənsi]	n.	 相差；差异；矛盾	
environment	[inˈvaiərənmənt]	n.	 环境，外界	
cast	[kɑ:st]	n.	 演员表	
serious	[ˈsiəriəs]	adj.	 严肃的；主要的；严重的，危急的；认真的	
eligible	[ˈelidʒəbl]	adj.	 符合条件的；合适的，合意的	
insulate	[ˈinsjuleit]	vt.	 隔离，孤立；使绝缘，使绝热	
gum	[ɡʌm]	n.	 树胶；口香糖；牙龈	
pilot	[ˈpailət]	v.	 驾驶（飞机等）；领航，引水	
electrical	[ɪˈlektrɪkl]	adj.	 电的，电学的	
commonwealth	[ˈkɔmənwelθ]	n.	 共和国，联邦，共同体，协会	
payment	[ˈpeimənt]	n.	 支付，付款额	
incidentally	[ˌɪnsiˈdentəli]	adv.	 附带地，顺便提及	
fame	[feim]	v.	 使出名；传扬…的名	
siege	[si:dʒ]	n.	 包围，围攻，围困	
river	[ˈrivə]	n.	 河流	
head	[hed]	v.	 主管；位于…顶部	
qualitative	[ˈkwɔlitətiv]	adj.	 性质上的，定性的	
candidate	[ˈkændidit]	n.	 候选人，候补者；报考者	
enroll	[inˈrəul]	v.	 （enrol）招收；登记；入学；参军；成为会员	
toss	[tɔs]	n.	 投，扔；摇动	
quilt	[kwilt]	n.	 被子	
fluid	[ˈflu:ɪd]	n.	 流体，液体	
excerpt	[ˈeksə:pt]	n.	 摘录；引用	
century	[ˈsentʃuri]	n.	 世纪，（一）百年	
stubborn	[ˈstʌbən]	adj.	 顽固的，倔强的；难对付的，难以克服的	
sorry	[ˈsɔri]	adj.	 对不起，抱歉的；难过，悔恨的；使人伤心	
gay	[ɡeɪ]	n.	 同性恋	
wagon	[ˈwæɡən]	n.	 运货马车，运货车；敞蓬车厢	
trim	[trim]	v.	 整理，修整，装饰	
drag	[dræɡ]	v.	 拖，拖曳	
suspicion	[səsˈpiʃən]	n.	 怀疑，猜疑；一点儿，少量	
ebb	[eb]	n.	 处于低潮，处于衰退状态	
dim	[dim]	adj.	 暗淡的，模糊的	
paralyze	[ˈpærəˌlaɪz]	v.	 （paralyse）使瘫痪（麻痹）；使丧失作用	
doll	[dɔl]	n.	 玩偶，玩具娃娃	
aggressive	[əˈɡresiv]	adj.	 侵略的，好斗的，有进取心的，敢作敢为的	
resolute	[ˈrezəˌlu:t]	adj.	 坚决的，果断的	
run	[rʌn]	v.	 奔，跑；流，淌；蔓延，伸展；经营；运转	
light	[lait]	adj.	 轻（快）；淡；明亮	
justify	[ˈdʒʌstifai]	v.	 证明…正当（或有理、正确），为…辩护	
tube	[tju:b]	n.	 管，软管；电子管，显像管；地铁	
plight	[plait]	v.	 保证，约定	
possibility	[ˌpɔsəˈbiliti]	n.	 可能，可能性；可能的事，希望	
fantasy	[ˈfæntəsi]	n.	 幻想，空想；空想的产物，幻想作品	
jog	[dʒɔɡ]	v.	 慢跑	
warfare	[ˈwɔ:fɛə]	n.	 战争（状态）；斗争；冲突	
landlord	[ˈlændlɔ:d]	n.	 房东，地主	
engineering	[ˌendʒiˈniəriŋ]	n.	 工程学	
rely	[riˈlai]	v.	 （on）依赖，依靠；信赖，信任	
reform	[riˈfɔ:m]	v.	 改革，改造，改良	
effect	[iˈfekt]	vt.	 招致；实现；达到	
rather	[ˈrɑ:ðə]	adv.	 相当，有一点儿；宁愿，宁可	
wherever	[hwɛəˈevə]	adv.	 无论在哪里，究竟在哪里	
globe	[ɡləub]	n.	 球体，地球仪；地球，世界	
pretty	[ˈpriti]	adj.	 漂亮的，俊俏的，标致的	
appear	[əˈpiə]	vi.	 出现；出场；问世；仿佛；出版，发表	
stove	[stəuv]	n.	 炉子，火炉	
principle	[ˈprinsəpl]	n.	 原理，原则；主义，信念	
advanced	[ədˈvɑ:nst]	adj.	 超前的，先进的；高级的；开明的；前进的	
pavement	[ˈpeɪvmənt]	n.	 人行道	
bury	[ˈberi]	v.	 埋（葬），安葬；埋藏，遮盖	
technology	[tekˈnɔlədʒi]	n.	 科学技术；工业技术；应用科学	
childhood	[ˈtʃaildhud]	n.	 幼年，童年	
feed	[fi:d]	v.	 喂养，饲养；向…供给	
mayor	[mɛə]	n.	 市长	
glory	[ˈɡlɔ:ri]	n.	 光荣，荣誉	
civil	[ˈsivl]	adj.	 公民的，市民的；民间的；民用的；有礼貌的	
opposite	[ˈɔpəzit]	n.	 对立面	
hip	[hip]	n.	 臀部，髋；屋脊	
burn	[bə:n]	n.	 烧伤，灼伤	
hurry	[ˈhʌri]	n.	 急（匆）忙	
dismay	[disˈmei]	n.	 （使）沮丧；（使）惊慌；（使）失望，（使）绝望	
soda	[ˈsəʊdə]	n.	 苏打，汽水	
autonomy	[ɔ:ˈtɔnəmi]	n.	 自治，自治权	
acknowledge	[əkˈnɔlidʒ]	vt.	 承认；接受；告知（信件等的）收到；答谢	
crystal	[ˈkristəl]	adj.	 水晶的，透明的	
explicit	[iksˈplisit]	adj.	 详述的，明确的；坦率的；显然的	
border	[ˈbɔ:də]	v.	 交界，与…接壤；接近	
bright	[brait]	adj.	 明亮的，辉煌的；聪明的；欢快的，美好的	
extraordinary	[ɪkˈstrɔːdnri]	adj.	 非常的；格外的；意外的；离奇的；临时的	
kneel	[ni:l]	v.	 跪，下跪	
feather	[ˈfeðə]	n.	 羽毛	
rejoice	[riˈdʒɔis]	v.	 （使）欣喜，（使）高兴	
broadcast	[ˈbrɔ:dkɑ:st]	v.	 广播（节目）	
competent	[ˈkɔmpitənt]	adj.	 有能力的，能胜任的；足够的	
obvious	[ˈɔbviəs]	adj.	 明显的，显而易见的	
sacrifice	[ˈsækrifais]	v.	 （for，to）牺牲，献出	
bandage	[ˈbændidʒ]	v.	 用绷带扎缚	
post	[pəust]	n.	 （支）柱；邮政，邮寄；职位	
ballet	[ˈbælei]	n.	 芭蕾舞，芭蕾舞剧；芭蕾舞团	
decide	[diˈsaid]	v.	 决定，下决心；解决，裁决	
plenty	[ˈplenti]	n.	 丰富，大量	
request	[riˈkwest]	v.	 请求，要求	
brace	[breis]	n.	 托架	
neighborhood	[ˈneɪbəˌhʊd]	n.	 （neighbourhood）邻居；四邻，街道	
hotel	[həuˈtel]	n.	 旅馆	
missile	[ˈmisail]	n.	 导弹，发射物	
physical	[ˈfizikəl]	adj.	 物质的；肉体的，身体的；自然科学的，物理的	
sketch	[sketʃ]	v.	 绘略图，速写，写生	
those	[ðəuz]	adj.	 [that的复数]那些；那些人（东西）	
youth	[ju:θ]	n.	 青年；年轻人	
molecule	[ˈmɔlikju:l]	n.	 分子	
cement	[siˈment]	v.	 胶合；巩固，加强	
plant	[plɑ:nt]	v.	 栽种，播种，栽培	
tribe	[traib]	n.	 种族，部落；（动植物）族，类	
evolution	[ˌi:vəˈlu:ʃən]	n.	 进化，演变，发展，进展	
chin	[tʃɪn]	n.	 下巴，颏	
abroad	[əˈbrɔ:d]	adv.	 到国外，在国外；在传播，在流传	
electrician	[ilekˈtriʃən]	n.	 电学家，电工	
beforehand	[biˈfɔ:hænd]	adv.	 预先，事先	
phenomenon	[fiˈnɔminən]	n.	 现象，稀有现象，珍品，奇迹，杰出人才	
insult	[inˈsʌlt]	v.	 侮辱，凌辱	
clothing	[ˈkləuðiŋ]	n.	 服装，衣服	
nowhere	[ˈnəuhwɛə]	adv.	 任何地方都不，没有地方	
author	[ˈɔ:θə]	n.	 作者，作家，著作人；创始人，发起人	
heavy	[ˈhevi]	adj.	 重的，重型的；沉重的，大量的，猛烈的	
attempt	[əˈtempt]	n.	 努力，尝试，企图	
moan	[məun]	v.	 呻吟，抱怨，悲叹	
garage	[ˈɡærɑ:ʒ]	n.	 车库，飞机库；修车厂	
cultivate	[ˈkʌltiveit]	v.	 耕作，栽培，养殖；培养，教养，磨炼	
revenge	[riˈvendʒ]	v.	 替…报仇	
strain	[strein]	n.	 拉紧；负担	
June	[dʒu:n]	n.	 六月	
sweater	[ˈswetə]	n.	 毛衣，绒衣，厚运动衫	
super	[ˈsju:pə]	adj.	 极好的，超级的	
budget	[ˈbʌdʒit]	v.	 做预算	
substitute	[ˈsʌbstitju:t]	v.	 （for）代替，替换	
cheap	[tʃi:p]	adj.	 便宜的；低劣的，不值钱的	
furthermore	[ˈfə:ðəˌmɔ:]	adv.	 而且，此外	
corner	[ˈkɔ:nə]	vt.	 将…逼入困境；垄断	
situation	[ˌsitjuˈeiʃən]	n.	 形势，处境，状况；位置，场所；职位，职务	
fuel	[fjuəl]	vt.	 给…加燃料	
germ	[dʒə:m]	n.	 微生物，细菌	
cosmic	[ˈkɔzmik]	adj.	 宇宙的；无比巨大的，无穷尽的	
coordinate	[kəuˈɔ:dineit]	vt.	 协作，协调	
copper	[ˈkɔpə]	n.	 铜；铜币，铜制器	
mile	[mail]	n.	 英里，哩，海里	
feat	[fi:t]	n.	 功绩，伟业，技艺	
undertake	[ˌʌndəˈteik]	v.	 承担，担任；许诺；着手，从事	
edge	[edʒ]	v.	 侧身移动，挤进	
brook	[bruk]	vt.	 [常用于否定句或疑问句]容忍	
resistant	[rɪˈzɪstənt]	adj.	 （to）抵抗的，有抵抗力的	
significant	[siɡˈnifikənt]	adj.	 有意义的；重大的，重要的	
theater	[ˈθiətə]	n.	 戏院；戏剧；电影院	
tentative	[ˈtentətiv]	adj.	 试探性的，暂时的；犹豫不决的	
need	[ni:d]	n.	 需要；贫困，困窘	
experimental	[iksˌperiˈmentəl]	adj.	 实验（性）的，试验（性）的	
grocer	[ˈɡrəusə]	n.	 食品商，杂货商	
fellowship	[ˈfeləuʃip]	n.	 伙伴关系；联谊会，团体	
hot	[hɔt]	adj.	 （炎）热的；辣的；急躁的；激动的；热衷的	
inspiration	[ˌɪnspəˈreiʃən]	n.	 灵感；鼓舞，激励	
addition	[əˈdiʃən]	n.	 加，加法；附加部分，增加（物）；另外	
result	[riˈzʌlt]	v.	 结果，致使，导致，由…而造成	
crane	[krein]	n.	 起重机；鹤	
differentiate	[ˌdifəˈrenʃieit]	v.	 区分，区别；（使）不同	
peace	[pi:s]	n.	 和平；平静，安宁	
brain	[brein]	n.	 （大）脑，骨髓；脑力，智能	
clockwise	[ˈklɔkwaiz]	adj.	 顺时针方向	
rail	[reil]	n.	 栏杆，围栏，横杆；铁路；铁轨	
irrespective	[ˌɪrisˈpektiv]	adj.	 不顾的，不考虑的	
denial	[diˈnaiəl]	n.	 否认；拒绝；否认某事或某事实的声明	
single	[ˈsiŋɡl]	adj.	 单人的；单一的，单个的；未婚的，独身的	
desk	[desk]	n.	 书桌，办公桌，服务台	
camera	[ˈkæmərə]	n.	 照相机，摄影机	
list	[list]	v.	 把…编列成表，列入表内	
summarize	[ˈsʌməraiz]	v.	 （summarise）概括，总结	
permanent	[ˈpə:mənənt]	adj.	 永久的，持久的	
darling	[ˈdɑ:liŋ]	n.	 心爱的人，亲爱的	
biscuit	[ˈbiskit]	n.	 饼干，点心	
southwest	[ˌsauθˈwest]	n.	 西南（的），西南部（的）	
exemplify	[ɪɡˈzɛmpləˌfaɪ]	v.	 举例证明；示范；作…的范例[榜样]	
superiority	[suːˌpɪəriˈɒrəti]	n.	 优越（性），优势，优等；高傲，傲慢	
cripple	[ˈkripl]	v.	 使跛，使残疾	
swallow	[ˈswɔləu]	vi.	 咽口水	
ambiguous	[æmˈbiɡjuəs]	adj.	 含糊的，不明确的；引起歧义的	
bucket	[ˈbʌkit]	n.	 水桶，吊桶	
equal	[ˈi:kwəl]	v.	 等于	
emergency	[iˈmə:dʒənsi]	n.	 紧急情况，突然事件，非常时刻	
essay	[ˈesei]	n.	 文章，短文	
thrust	[θrʌst]	vi.	 刺，戳，冲	
basic	[ˈbeisik]	adj.	 基本的，基础的	
reduce	[riˈdju:s]	v.	 减少，缩小；简化，还原	
bone	[bəun]	n.	 骨（骼），骨头	
step	[step]	v.	 踏，走，举步	
respond	[riˈspɔnd]	v.	 回答，响应，作出反应	
gallon	[ˈɡælən]	n.	 加仑	
whereas	[hwɛərˈæz]	conj.	 但是，然而，却，反之	
come	[kʌm]	v.	 来；产生；是，成为；开始	
generate	[ˈdʒenəreit]	vt.	 产生，发生；生殖	
settlement	[ˈsetlmənt]	n.	 解决，决定，调停；居留区，住宅区	
utilize	[ˈju:tilaiz]	vt.	 利用	
innovation	[ˌɪnəuˈveiʃən]	n.	 改革，革新；新观念，新方法，新发明	
announce	[əˈnauns]	v.	 正式宣布；发表；通告；广播	
compute	[kəmˈpju:t]	v.	 计算，估计	
verdict	[ˈvə:dikt]	n.	 裁决，判决；判断；定论	
epoch	[ˈi:pɔk]	n.	 新纪元；时代；时期；[地质]世，纪，期	
red	[red]	n.	 红色；红色颜料	
accordance	[əˈkɔ:dəns]	n.	 一致，和谐，符合	
regard	[riˈɡɑ:d]	n.	 敬重，重视；问候	
exit	[ˈeksit]	n.	 出口，通道	
federal	[ˈfedərəl]	adj.	 联邦的；联邦制的；联合的；同盟的	
napkin	[ˈnæpkin]	n.	 餐巾，餐巾纸，<英>尿布	
clay	[klei]	n.	 粘土，泥土	
harm	[hɑ:m]	n.	 伤害，损害，危害	
talk	[tɔ:k]	v.	 说话；交谈	
she	[ʃi:]	pron.	 （主格）她	
displace	[disˈpleis]	v.	 移置，转移；取代，置换	
cite	[sait]	v.	 引用，引证，举（例），提及	
accommodate	[əˈkɔmədeit]	vt.	 向…提供住处；容纳，接纳；顾及	
tackle	[ˈtækl]	v.	 处理，解决；抱住，抓住	
under	[ˈʌndə]	adv.	 在下面；少于	
whale	[hweil]	n.	 鲸；庞然大物	
adequate	[ˈædikwit]	adj.	 充足的，足够的；适当的，胜任的	
despite	[disˈpait]	prep.	 不管，不顾	
organization	[ˌɔ:ɡənaiˈzeiʃən]	n.	 组织，团体，机构	
although	[ɔ:lˈðəu]	conj.	 尽管，虽然…但是	
cunning	[ˈkʌniŋ]	adj.	 狡猾（的），狡诈（的）	
stripe	[straip]	n.	 长条，条纹；军服上表示军阶的臂章条纹	
accordingly	[əˈkɔ:diŋli]	adv.	 相应地，照着办，按照；于是，因此	
expend	[iksˈpend]	v.	 消费，花费	
convention	[kənˈvenʃən]	n.	 大会，会议；惯例，常规，习俗；公约，协定	
brittle	[ˈbritl]	adj.	 易碎的；脆弱的；冷淡的；（声音）尖利的	
numerous	[ˈnju:mərəs]	adj.	 众多的，许多的，大批的	
course	[kɔː(r)s]	n.	 课程；过程，进程；路程，路线；一道菜	
mineral	[ˈminərəl]	adj.	 矿物的，矿质的	
laugh	[lɑ:f]	n.	 笑，笑声	
degenerate	[diˈdʒenəreit]	n.	 堕落者	
investment	[inˈvestmənt]	n.	 投资；投资金额；投资物	
wholesome	[ˈhəulsəm]	adj.	 卫生的；有益的；健康的，有益健康的	
anxiety	[ænˈzaiəti]	n.	 挂念，焦虑，焦急，忧虑；渴望	
stay	[stei]	n.	 逗留，停留	
worst	[wə:st]	adj.	 最坏（的），最差（的）	
rich	[ritʃ]	adj.	 有钱的；富饶的；（in）充足的，丰富的	
photo	[ˈfəutəu]	n.	 （photograph）照片	
dot	[dɔt]	v.	 在…上打点	
limb	[lim]	n.	 肢，翼，大树枝	
politician	[ˌpɔliˈtiʃən]	n.	 政治家，政客	
fox	[fɔks]	n.	 狐狸	
momentum	[məuˈmentəm]	n.	 动力，要素	
province	[ˈprɔvins]	n.	 省；领域，范围，本分	
transistor	[trænˈsistə]	n.	 晶体管；晶体管收音机	
least	[li:st]	adv.	 最小；最少	
here	[hiə]	adv.	 在（到，向）这里；这时；在这一点上	
song	[sɔŋ]	n.	 歌唱，（鸟等）鸣声；歌曲，歌词	
multiply	[ˈmʌltiplai]	v.	 （by）乘，使相乘；倍增，增加，繁殖	
signify	[ˈsiɡnifai]	v.	 表示，意味；要紧，有重要性	
actor	[ˈæktə]	n.	 男演员；演员，行动者	
realise	[ˈriəlaiz]	v.	 （realize）认识到，体会到；实现	
campus	[ˈkæmpəs]	n.	 （大学）校园	
arouse	[əˈrauz]	vt.	 唤醒，叫醒；唤起，激起	
bell	[bel]	n.	 钟，铃	
god	[ɡɔd]	n.	 泛指所有的神，神像	
ruin	[ˈruin]	n.	）废墟	
salad	[ˈsæləd]	n.	 色拉，凉拌菜	
goal	[ɡəul]	n.	 目的，目标；守门员，球门；进球	
baseball	[ˈbeisbɔ:l]	n.	 棒球	
obtain	[əbˈtein]	v.	 获得，得到	
custom	[ˈkʌstəm]	n.	 习惯，风俗，惯例	
pork	[pɔ:k]	n.	 猪肉	
length	[leŋθ]	n.	 长，长度；一段，一节，程度，范围	
endow	[inˈdau]	vt.	 资助，捐赠；（with）给予，赋予	
either	[ˈaiðə]	adj.	 （两者中）任一的	
opening	[ˈəupəniŋ]	adj.	 开始的，开幕的	
interference	[ˌɪntəˈfiərəns]	n.	 （in）干涉，干预；（with）妨碍，打扰	
cease	[si:s]	v.	 停止，中止	
basis	[ˈbeisis]	n.	 基础，根据；基本原则	
subsequent	[ˈsʌbsikwənt]	adj.	 随后的，后来的	
regret	[riˈɡret]	v.	 遗憾，懊悔，抱歉	
frequent	[ˈfri:kwənt]	adj.	 时常发生的，频繁的	
necessary	[ˈnesisəri]	n.	 必需品	
overthrow	[ˌəuvəˈθrəu]	v.	 推翻，颠覆	
levy	[ˈli:vi]	v.	 征收，征集，征用	
arrogant	[ˈærəɡənt]	adj.	 傲慢的，自大的	
fiber	['faɪbə]	n.	 （fibre）纤维；构造；纤维制品	
rope	[rəup]	n.	 绳，索	
tune	[tju:n]	vt.	 调音，调节，调整	
chorus	[ˈkɔ:rəs]	v.	 异口同声地说，随声附和	
pronoun	[ˈprəunaun]	n.	 代词	
mill	[mil]	n.	 磨粉机，磨坊；作坊，工厂	
accept	[əkˈsept]	v.	 接受，领受；认可，同意	
temporary	[ˈtempərəri]	adj.	 暂时的，临时的	
overhead	[ˈəuvəhed]	adv.	 在头顶上	
alter	[ˈɔ:ltə]	vi.	 改变，变化	
rat	[ræt]	n.	 鼠	
pope	[pu:p]	n.	 罗马教皇，主教，大腿上要害部位	
transport	[trænsˈpɔ:t]	n.	 运输；运输系统，运载工具	
pole	[pəul]	n.	 柱，杆；地极，磁极，电极	
pad	[pæd]	v.	 加上衬垫	
panda	[ˈpændə]	n.	 熊猫	
kick	[kik]	n.	 踢	
appointment	[əˈpɔintmənt]	n.	 约会，约定；任命，委派；委任的职位	
lend	[lend]	vt.	 借给，贷（款）	
complete	[kəmˈpli:t]	v.	 完成，结束，使完满	
period	[ˈpiəriəd]	n.	 时期，时代；学时；周期，一段时间；句点	
destination	[ˌdestiˈneiʃən]	n.	 目的地，终点	
immediate	[iˈmi:diət]	adj.	 立即的，即时的；直接的，最接近的	
imagine	[iˈmædʒin]	v.	 想象，设想，料想	
triumph	[ˈtraiəmf]	v.	 得胜，战胜	
twin	[twin]	n.	 孪生子，双生子	
appropriate	[əˈprəupriit]	vt.	 拨给，挪用，盗用	
these	[ði:z]	pron.	 [this的复数]这些；这些人（东西）	
consistent	[kənˈsistənt]	adj.	 （in）前后一致的；（with一致，符合	
never	[ˈnevə]	adv.	 永不，从不，决不；从来没有；不，没有	
equality	[i:ˈkwɔliti]	n.	 同等；平等；相等；等式；等同性	
belong	[biˈlɔŋ]	v.	 （to）属于，附属，隶属；应归入（类别，范畴等）	
option	[ˈɔpʃən]	n.	 选择（权），[商]选择买卖的特权	
dirty	[ˈdə:ti]	v.	 弄脏，玷污	
unexpected	[ˌʌnɪkˈspektɪd]	adj.	 想不到的，意外的，未预料到	
thermometer	[θəˈmɔmitə]	n.	 温度计	
hostess	[ˈhəʊstɪs]	n.	 女主人，女主持人	
storage	[ˈstɔ:ridʒ]	n.	 贮藏（量），保管；库房	
swing	[swiŋ]	n.	 秋千；摇摆，摆动	
forgive	[fəˈɡiv]	v.	 原谅，饶恕	
walk	[wɔ:k]	n.	 步行；步态；步行的路径	
debate	[	v.	 争论，辩论，讨论	
license	[ˈlaisəns]	v.	 准许，认可	
button	[ˈbʌtən]	v.	 扣紧；扣上纽扣	
leg	[leɡ]	n.	 腿，腿部；支柱；（旅程的）一段，一站	
tomato	[təˈmɑ:təu]	n.	 西红柿	
imperial	[imˈpiəriəl]	adj.	 帝国的，帝王的；（度量衡）英制的	
deny	[diˈnai]	v.	 否认，否定；拒绝	
refine	[riˈfain]	v.	 精炼，精制，提纯；使文雅，使高尚	
sleeve	[sli:v]	n.	 袖子	
wise	[waiz]	adj.	 有智慧的，聪明的	
humor	[ˈhju:mə]	n.	 （humour）幽默，诙谐	
racial	[ˈreiʃəl]	adj.	 种的，种族的	
helpful	[ˈhelpful]	adj.	 （to）有帮助的，有益的，有用的	
scarce	[skɛəs]	adj.	 缺乏的，不足的；稀少的，罕见的	
overtake	[ˌəuvəˈteik]	v.	 追上，超过，突然降临，压倒	
reference	[ˈrefrəns]	n.	 提及，涉及；参考，参考书目；证明书（人）	
blue	[blu:]	n.	 蓝色	
cent	[sent]	n.	 分（币）；百percent百分之…	
exploit	[iksˈplɔit]	n.	 功绩，功勋；业绩	
husband	[ˈhʌzbənd]	n.	 丈夫	
terminal	[ˈtə:minəl]	n.	 终点（站）；终端	
sole	[səul]	n.	 脚垫，鞋底	
affection	[əˈfekʃən]	n.	 爱，喜爱；爱慕之情；感情；疾病，不适	
sir	[sə:]	n.	 先生，长官；…爵士	
process	[ˈprəuses]	v.	 加工，处理	
mosaic	[məʊˈzeɪɪk]	n.	 马赛克；镶嵌体	
unusual	[ˌʌnˈju:ʒuəl]	adj.	 不平常的，与众不同的	
bay	[bei]	n.	 海湾，（港）湾	
fruit	[fru:t]	n.	 水果，果实；成果，效果	
coast	[kəust]	n.	 海岸，海滨	
rehearsal	[riˈhə:səl]	n.	 排练，排演，演习，预演，试演	
depart	[diˈpɑ:t]	adj.	 过去的，逝世的	
connect	[kəˈnekt]	vi.	 连接	
loose	[lu:s]	adj.	 （宽）松的；不精确的；自由的，散漫的	
reap	[ri:p]	v.	 收割，收获	
observation	[ˌɔbzə:ˈveiʃən]	n.	 观察，观测，监视	
republic	[riˈpʌblik]	n.	 共和国，共和政体	
involve	[inˈvɔlv]	v.	 卷入；包含；涉及	
battery	[ˈbætəri]	n.	 电池（组）；一组，一套；炮兵连	
aluminum	[əˈlu:mənəm]	n.	 （aluminium）铝	
destruction	[disˈtrʌkʃən]	n.	 毁坏，毁灭（的原因）	
preserve	[priˈzə:v]	v.	 保护，维持；保存，保藏	
lifetime	[ˈlaifˌtaim]	n.	 一生，终生	
day	[dei]	n.	 天，一昼夜；白昼，白天；时期，时代	
boat	[bəut]	n.	 小船，艇	
medicine	[ˈmedisin]	n.	 内服药，医药；医术；医学，内科学	
comprise	[kəmˈpraiz]	vt.	 包含，包括，由…组成；构成，组成	
bankrupt	[ˈbæŋkrʌpt]	n.	 破产者	
sulfur	[ˈsʌlfə]	n.	 （sulphur）硫	
campaign	[kæmˈpein]	n.	 战役；运动	
proof	[pru:f]	n.	 证据，证明；校样，样张	
cemetery	[ˈsemitri]	n.	 坟墓，墓地，坟场	
input	[ˈinput]	v.	 输入	
angel	[ˈeindʒəl]	n.	 天使，安琪儿	
deem	[di:m]	v.	 认为，相信	
attitude	[ˈætitju:d]	n.	 态度，看法（to，toward，about）；姿势	
bow	[bəu]	n.	 鞠躬；弓（形）；蝴蝶结	
combat	[ˈkɔmbət]	v.	 战斗，搏斗，格斗	
authentic	[ɔ:ˈθentik]	adj.	 真的，真正的；可靠的，可信的，有根据的	
illustration	[ˌɪləˈstreiʃən]	n.	 说明；例证，插图；举例说明	
disorder	[disˈɔ:də]	n.	 混乱，杂乱；骚乱；失调，疾病	
statute	[ˈstætju:t]	n.	 成文法，法令，法规；章程，规则，条例	
remedy	[ˈremidi]	v.	 治疗，医治；纠正，补救	
prepare	[priˈpɛə]	v.	 准备，预备	
premise	[ˈpremis]	v.	 提论，预述，假定	
pilgrim	[ˈpilɡrim]	n.	 （在国外）旅游者；朝圣者，最初的移民	
chip	[tʃip]	n.	 切屑，碎片；（土豆等的）薄片；集成电路块	
latent	[ˈleitənt]	adj.	 潜在的，潜伏的，不易察觉的	
disappoint	[ˌdisəˈpɔint]	vt.	 失望；（希望等）破灭，挫败（计划等）	
razor	[ˈreizə]	n.	 剃刀	
voyage	[ˈvɔiidʒ]	n.	 航海；航行；旅行	
normal	[ˈnɔ:məl]	adj.	 正常的，普通的；正规的，标准的	
adjust	[əˈdʒʌst]	vi.	 适应（to）；使调节	
sigh	[sai]	v.	 叹息，叹气	
negotiate	[niˈɡəuʃieit]	v.	 商订；谈判，洽谈，交涉	
prose	[prəuz]	adj.	 散文的	
rush	[rʌʃ]	adj.	 （交通）繁忙的	
bowl	[bəul]	n.	 碗（状物），钵	
excess	[ˈekses]	n.	 过量；过剩；超额；无节制	
sun	[sʌn]	n.	 太阳；恒星	
might	[mait]	n.	 力量，威力，权力	
miss	[mis]	v.	 思念，未击中，错过，漏掉，逃脱	
location	[ləuˈkeiʃən]	n.	 位置，场所，定位，测位	
crash	[kræʃ]	n.	 撞坏，撞碎；失败，瓦解；爆裂声	
specimen	[ˈspesimən]	n.	 标本，样本	
feminine	[ˈfeminin]	adj.	 女性的；娇柔的	
news	[nju:z]	n.	 新闻，消息；新闻报道，新闻广播	
ambulance	[ˈæmbjuləns]	n.	 救护车，救护船，救护飞机	
strive	[straiv]	v.	 奋斗，努力	
find	[faind]	v.	 （found，found）找到；发现；发觉；感到	
interview	[ˈintəvju:]	n.	 面试；面谈；采访	
greenhouse	[ˈɡri:nhaus]	n.	 温室	
damp	[dæmp]	vt.	 使潮湿；使衰减	
saint	[seint]	n.	 圣人，基督教徒	
busy	[ˈbizi]	adj.	 忙碌的；热闹的，繁忙的；占线	
ashore	[əˈʃɔ:]	adv.	 上岸；在岸上，向岸上	
productive	[prəˈdʌktiv]	adj.	 生产（性）的，能产的，多产的	
south	[sauθ]	adj.	 南方的，南部的	
box	[bɔks]	v.	 把…装箱；拳击，打耳光	
hound	[haund]	vt.	 用猎狗追，追逐	
conclude	[kənˈklu:d]	v.	 结束，终止；断定，下结论；缔结，议定	
typical	[ˈtipikəl]	adj.	 （of）典型的，有代表性的	
vice	[vais]	n.	 邪恶；恶习；台钳，老虎钳	
terminate	[ˈtə:mineit]	vi.	 （使）结束，（使）停止	
body	[ˈbɔdi]	n.	 身体，本体；主体；尸体；物体；（一）群，批，堆	
merry	[ˈmeri]	adj.	 欢乐的，愉快的	
add	[æd]	vi.	 （to）增添	
shame	[ʃeim]	v.	 使羞愧	
worse	[wə:s]	adj.	 更坏，更差（的/地）	
master	[ˈmɑ:stə]	adj.	 主要的	
movement	[ˈmu:vmənt]	n.	 运动，活动；移动，迁移	
era	[ˈɪərə]	n.	 时代，年代，阶段，纪元	
yearly	[ˈjə:li]	adv.	 每年，一年一次地	
extravagant	[iksˈtræviɡənt]	adj.	 奢侈的；过分的；（言行等）放肆的	
team	[ti:m]	v.	 协同工作	
rarely	[ˈrɛəli]	adv.	 很少，难得，非常地	
plate	[pleit]	v.	 镀，电镀	
stock	[stɔk]	v.	 储存	
diary	[ˈdaiəri]	n.	 日记，日记簿	
cheek	[tʃi:k]	n.	 面颊，脸	
about	[əˈbaut]	adj.	 准备	
sea	[si:]	n.	 海，海洋，大量	
clash	[klæʃ]	n.	 碰撞声	
bundle	[ˈbʌndl]	n.	 捆，包，束	
brave	[breiv]	v.	 勇敢地面对（危险等）	
throat	[θrəut]	n.	 咽喉，嗓子	
lord	[lɔ:d]	n.	 （Lord）上帝，主；主人，长官，君主，贵族	
prosper	[ˈprɔspə]	v.	 成功，兴隆，昌盛，使成功，使昌隆，繁荣	
toe	[təʊ]	n.	 脚趾，足尖	
volleyball	[ˈvɔlibɔ:l]	n.	 排球	
attendant	[əˈtendənt]	adj.	 出席的；伴随的	
tiger	[ˈtaiɡə]	n.	 虎；老虎	
cushion	[ˈkuʃən]	vt.	 装垫子；缓和，减轻	
collective	[kəˈlektiv]	adj.	 集体的，共同的	
status	[ˈsteitəs]	n.	 地位，身份；情形，状况	
discard	[disˈkɑ:d]	vt.	 丢弃，抛弃，遗弃	
perfect	[ˈpə:fikt]	adj.	 使完美	
mainland	[ˈmeinlənd]	n.	 大陆，本土	
army	[ˈɑ:mi]	n.	 军队，陆军，军；大群，大批	
terrible	[ˈterəbl]	adj.	 很糟的；可怕的，骇人的；极度的，厉害的	
miniature	[ˈminiətʃə]	adj.	 微型的，缩小的	
motion	[ˈməuʃən]	v.	 提议，动议	
saturate	[ˈsætʃəreit]	vt.	 使湿透，浸透；使充满，使饱和	
literature	[ˈlitəritʃə]	n.	 文学，文学作品，文献，图书资料，印刷品	
fashionable	[ˈfæʃənəbl]	adj.	 流行的，时髦的	
shrink	[ʃriŋk]	v.	 起皱，收缩；退缩，畏缩	
gesture	[ˈdʒestʃə]	v.	 做手势	
tilt	[tilt]	n.	 倾侧；倾斜	
magnificent	[mæɡˈnifisənt]	adj.	 华丽的，高尚的，宏伟的	
nature	[ˈneitʃə]	n.	 自然界，大自然；性质，本性，天性	
harvest	[ˈhɑ:vist]	v.	 收获，收割	
joy	[dʒɔi]	n.	 欢乐，喜悦；乐事，乐趣	
none	[nʌn]	adv.	 一点也不	
cloud	[klaud]	n.	 云（状物）；遮暗物，阴影；一大群	
namely	[ˈneimli]	adv.	 即，也就是	
pear	[pɛə]	n.	 梨子，梨树	
rake	[reik]	v.	 耙；搜索，探索	
badly	[ˈbædli]	adv.	 非常，严重地；坏地，差地，拙劣地	
handwriting	[ˈhændˌraitiŋ]	n.	 笔迹，手迹，书法	
downtown	[ˈdaunˈtaun]	n.	 城市商业区（的）	
substance	[ˈsʌbstəns]	n.	 物质；实质，本质；主旨；财产，资产	
calculate	[ˈkælkjuleit]	v.	 计算，推算；计划，打算	
combination	[ˌkɔmbiˈneiʃən]	n.	 结合，联合；化合；团体；组合数码	
proficiency	[prəˈfiʃənsi]	n.	 （in）熟练，精通	
museum	[mju:ˈziəm]	n.	 博物馆，展览馆	
optimistic	[ˌɒptɪˈmɪstɪk]	adj.	 乐观主义的	
employment	[imˈplɔimənt]	n.	 雇用；使用；工作，职业	
living	[ˈliviŋ]	n.	 生活，生计	
lemon	[ˈlemən]	n.	 柠檬	
astronaut	[ˈæstrənɔ:t]	n.	 太空人，太空旅行者	
cater	[ˈkeitə]	vi.	 （for/to）满足，迎合；（for）提供饮食及服务	
tumble	[ˈtʌmbl]	n.	 摔跤，跌倒	
forty	[ˈfɔ:ti:]	pron.	 四十（个，只…）	
petrol	[ˈpetrəl]	n.	 汽油	
grab	[ɡræb]	v.	 （at）抓（住）；夺（得）；吸引（某人的注意）	
on	[ɔn]	adv.	 向前，继续	
timely	[ˈtaimli]	adj.	 及时的，适时的	
paste	[peist]	v.	 粘，贴	
percent	[pəˈsent]	n.	 百分比	
promise	[ˈprɔmis]	n.	 承诺；希望，出息	
cage	[keidʒ]	n.	 鸟笼	
necklace	[ˈneklis]	n.	 项链，项圈	
cinema	[ˈsinəmə]	n.	 电影院；电影，影片	
eat	[i:t]	vi.	 吃饭，吃东西	
skill	[skil]	n.	 技能，技巧，手艺；熟练	
flash	[flæʃ]	v.	 发闪光，闪亮；闪现	
verge	[və:dʒ]	v.	 濒临	
smile	[smail]	vi.	 微笑，露出笑容	
vapour	[ˈveipə]	n.	 （vapor）汽，（水）蒸气	
stop	[stɔp]	n.	 停车站；停止	
lamp	[læmp]	n.	 灯	
heroine	[ˈherəuin]	n.	 女英雄；女主角	
shade	[ʃeid]	v.	 遮蔽，遮光	
definite	[ˈdefinit]	adj.	 明确的；一定的；意志坚强的，立场坚定的	
nose	[nəuz]	n.	 鼻子；（飞机，船等的）前端，突出部分	
miserable	[ˈmizərəbl]	adj.	 痛苦的，悲惨的	
respect	[risˈpekt]	n.	 尊敬；敬意，问候，关系，方面	
bench	[bentʃ]	n.	 长凳，条凳；（工作）台，座	
blackboard	[ˈblækbɔ:d]	n.	 黑板	
dose	[dəus]	v.	 （给…）服药	
sophisticated	[səˈfistikeitid]	adj.	 尖端的，复杂的，先进的；老练的	
haste	[heist]	v.	 赶快；匆忙	
headmaster	[ˈhedˈmɑ:stə]	n.	 校长	
affirm	[əˈfə:m]	vt.	 断言，坚持声称；肯定；证实，确认	
application	[ˌæpliˈkeiʃən]	n.	 申请，请求，申请书；应用，实用性	
mutter	[ˈmʌtə]	v.	 低声说，抱怨	
slender	[ˈslendə]	adj.	 修长的，细长的，苗条的；微薄的	
predecessor	[ˈpri:disesə]	n.	 前辈，前任	
exclude	[iksˈklu:d]	v.	 拒绝，把…排除在外，排斥	
grateful	[ˈɡreitful]	adj.	 （to，for）感激的；感谢的	
heroin	[ˈherəʊɪn]	n.	 海洛因	
poem	[ˈpəuim]	n.	 诗	
bind	[baind]	v.	 捆，绑，束缚；结合	
diagram	[ˈdaiəɡræm]	n.	 图表；图解	
obedient	[əˈbi:djənt]	adj.	 服从的，顺从的	
symmetry	[ˈsimitri]	n.	 对称（性）；匀称，整齐	
error	[ˈerə]	n.	 错误，过失	
fire	[ˈfaiə]	vt.	 放（枪）	
width	[widθ]	n.	 宽度；宽阔，广阔	
mix	[miks]	v.	 使混合；混淆	
make	[meik]	vt.	 制造，做成，准备	
useful	[ˈju:sful]	adj.	 有用的，实用的；有益的，有帮助的	
evident	[ˈevidənt]	adj.	 明显的，明白的	
patriotic	[ˌpætriˈɔtik]	adj.	 爱国的	
envy	[ˈenvi]	v.	 羡慕，忌妒	
establishment	[isˈtæbliʃmənt]	n.	 建立，设立，建立的机构（或组织）	
historic	[hisˈtɔrik]	adj.	 有历史意义的；历史的	
bear	[bɛə]	v.	 忍受，容忍；负担；结果实，生子女	
interior	[inˈtiəriə]	n.	 内部，内地	
importance	[imˈpɔ:təns]	n.	 重要，重要性	
immune	[iˈmju:n]	adj.	 免疫的，有免疫力的；有受影响的；豁免的	
cut	[kʌt]	n.	 切口，伤口；削减；剪裁	
sincere	[sinˈsiə]	adj.	 诚挚的，真实的，诚恳的	
farther	[ˈfɑ:ðə]	adj.	 更远的	
yawn	[jɔ:n]	n.	 呵欠	
inflation	[inˈfleiʃən]	n.	 通货膨胀	
splendid	[ˈsplendid]	adj.	 壮丽的，辉煌的；极好的	
skin	[skin]	v.	 剥皮	
whom	[hu:m]	pron.	 谁；哪个人（who的宾格）	
superstition	[ˌsju:pəˈstiʃən]	n.	 迷信，迷信的观念习俗	
pneumonia	[nju:ˈməunjə]	n.	 肺炎	
lawn	[lɔ:n]	n.	 草地，草坪	
male	[meil]	n.	 男性（的），雄性（的）	
density	[ˈdensiti]	n.	 密集，密度，浓度	
should	[ʃud]	v.	 应该；万一；可能，该；就；竟然会	
high	[hai]	adv.	 高高地	
decrease	[di:ˈkri:s]	v.	 减少，变少，降低	
shallow	[ˈʃæləu]	n.	 浅滩，浅处	
famine	[ˈfæmin]	n.	 饥荒，饥馑，饥饿	
dignity	[ˈdiɡniti]	n.	 （举止，态度等的）庄严，端庄；尊贵，高贵；尊严	
anchor	[ˈæŋkə]	n.	 锚；危难时可依靠的人或物；用锚泊船	
tendency	[ˈtendənsi]	n.	 趋势，趋向；倾向	
cord	[kɔ:d]	n.	 绳，索	
lately	[ˈleitli]	adv.	 最近，不久前	
middle	[ˈmidl]	n.	 中间（的），当中（的）	
ambition	[æmˈbiʃən]	n.	 对（成功、权力等）的强烈欲望，野心；雄心	
vacant	[ˈveikənt]	adj.	 空的，未占用的；空缺的；神情茫然的	
procedure	[prəˈsi:dʒə]	n.	 程序，手续，步骤	
athlete	[ˈæθli:t]	n.	 运动员，体育家，身强力壮的人	
vibrate	[vaiˈbreit]	v.	 （使）振动，（使）摇摆；受…而感动	
cure	[kjuə]	n.	 治愈，痊愈；良药	
dispute	[disˈpju:t]	v.	 争论，辩论；反驳；怀疑；阻止	
suggestion	[səˈdʒestʃən]	n.	 建议，意见；细微的迹象；暗示，联想	
priority	[praiˈɔriti]	n.	 先，前；优先，重点，优先权	
export	[eksˈpɔ:t]	n.	 输出，出口；出口商品	
thus	[ðʌs]	adv.	 如此；像这样；于是；因此	
huddle	[ˈhʌdl]	v.	 （因寒冷、害怕而）缩成一团；使聚集；挤在一起	
temple	[ˈtempl]	n.	 庙宇，神殿，寺；太阳穴	
pant	[pænt]	v.	 喘，气喘吁吁地说	
Friday	[ˈfraidi]	n.	 星期五	
memorial	[miˈmɔ:riəl]	n.	 纪念物，纪念碑，纪念馆	
salary	[ˈsæləri]	n.	 薪金，薪水	
smog	[smɔɡ]	n.	 烟雾	
convert	[kənˈvə:t]	v.	 变换，转换；改变（信仰等）；兑换（钱）	
quarterly	[ˈkwɔ:təli]	n.	 季刊	
bath	[bɑ:θ]	v.	 （给…）洗澡	
usual	[ˈju:ʒuəl]	adj.	 通常的，平常的	
northeast	[nɔ:θˈi:st]	adv.	 向东北，在东北	
affair	[əˈfɛə]	n.	 事务；事情（件）；私事	
gorgeous	[ˈɡɔ:dʒəs]	adj.	 华丽的；灿烂的；美丽的；宜人的；棒的	
downstairs	[ˈdaunˈstɛəz]	adv.	 在楼下，往楼下	
production	[prəˈdʌkʃən]	n.	 生产，产品，作品，（研究）成果，总产量	
each	[i:tʃ]	adj.	 各，各自的，每	
suite	[swi:t]	n.	 套间；一套家具；组，系列	
hall	[hɔ:l]	n.	 礼堂，会堂，办公大楼，门厅	
he	[hi:]	pron.	 他；（不论性别的）一个人	
rank	[ræŋk]	v.	 分等级，把…分类	
linger	[ˈliŋɡə]	v.	 逗留，徘徊，拖延，留恋，浪费光阴，苟延残喘	
fairly	[ˈfɛəli]	adv.	 公正地，正当地；相当，还算	
recognize	[ˈrekəɡnaiz]	v.	 （recognise）认出，承认，公认，赏识，表扬	
equipment	[iˈkwipmənt]	n.	 设备，器材，装置；才能	
surroundings	[səˈraundiŋz]	n.	 周围的事物，环境	
reservoir	[ˈrezəvwɑ:]	n.	 水库，蓄水池	
synthetic	[sinˈθetik]	adj.	 合成的，人造的；综合的	
hunt	[hʌnt]	v.	 打猎，猎取；（for）搜索；寻找	
majority	[məˈdʒɔriti]	n.	 多数，大多数，成年，法定年龄	
mosquito	[məsˈki:təu]	n.	 蚊子	
lock	[lɔk]	v.	 锁，锁上	
festival	[	adj.	 节日的；快乐的	
butter	[ˈbʌtə]	v.	 涂黄油于…上	
everybody	[ˈevribɔdi]	pron.	 每人，人人	
bake	[beik]	v.	 烤，烘，焙；烧硬，焙干	
trouble	[ˈtrʌbl]	v.	 （使）烦恼	
brutal	[ˈbru:tl]	adj.	 残忍的；严峻的；严酷的	
seemingly	[ˈsiːmɪŋli]	adv.	 外观上，表面上	
contact	[ˈkɔntækt]	v.	 （使）接触，联系，交往	
strike	[straik]	v.	 打，击；攻击；给…深刻印象；罢工	
forget	[fəˈɡet]	v.	 忘记，遗忘	
obscure	[əbˈskjuə]	adj.	 暗的，朦胧的；模糊的，晦涩的	
advent	[ˈædvənt]	n.	 （重要事件等的）到来，来临	
October	[ɔkˈtəubə]	n.	 十月	
zoo	[zu:]	n.	 动物园	
satisfactory	[ˌsætisˈfæktəri]	adj.	 令人满意的，圆满的，良好的，符合要求的	
finger	[ˈfiŋɡə]	n.	 手指；指状物；指针	
western	[ˈwestən]	adj.	 西方的，西部的	
glad	[ɡlæd]	adj.	 高兴的，快活的；乐意的，情愿的	
largely	[ˈlɑ:dʒli]	adv.	 主要地，基本上；大量地，大规模地	
cabinet	[ˈkæbinit]	n.	 内阁，内阁会议；（带玻璃门存物品的）橱柜	
persist	[pəˈsist]	v.	 （in）坚持，持续	
university	[ˌjuːnɪˈvɜː(r)səti]	n.	 大学	
moss	[mɔs]	n.	 苔，藓，地衣	
organize	[ˈɔrɡəˌnaɪz]	v.	 （organise）组织，编组	
editor	[ˈeditə]	n.	 编辑，编者	
item	[ˈaitəm]	n.	 条（款），项目；一则（新闻），（戏剧的）节目	
charter	[ˈtʃɑ:tə]	n.	 宪章，特许状	
common	[ˈkɔmən]	n.	 公有地	
versus	[ˈvə:səs]	prep.	 …对…（在诉讼，比赛等）；与…相对	
half	[hɑ:f]	adv.	 一半地	
intricate	[ˈintrikit]	adj.	 复杂精细的；错综复杂的	
train	[trein]	v.	 训练，培养	
them	[ðem]	pron.	 他们/她们/它们（they的宾格形式）	
delay	[diˈlei]	v.	 耽搁，延迟	
comment	[ˈkɔment]	v.	 （on）注释，评论	
eyebrow	[ˈaibrau]	n.	 眉毛	
medium	[ˈmi:djəm]	adj.	 中等的	
condemn	[kənˈdem]	v.	 谴责，指责；判刑，宣告有罪	
flag	[flæɡ]	n.	 旗	
litre	[ˈli:tə]	n.	 （liter）升；公升（容量单位）	
abound	[əˈbaund]	vi.	 大量存在；（in，with）充满，富于	
fluctuate	[ˈflʌktjueit]	v.	 （使）波动；（使）起伏	
pick	[pik]	n.	 镐，鹤嘴锄	
learning	[ˈlə:niŋ]	n.	 知识，学问；学习	
outing	[ˈaʊtɪŋ]	n.	 外出，旅行，散步	
forum	[ˈfɔ:rəm]	n.	 论坛，讨论会	
deaf	[def]	adj.	 聋的；不愿听的	
love	[lʌv]	vt.	 爱，热爱；爱好，喜欢	
radiant	[ˈreidiənt]	adj.	 发光的，辐射的，容光焕发的	
statement	[	n.	 声明，陈述	
sword	[sɔ:d]	n.	 剑，刀；武力	
finally	[ˈfaɪnəli]	adv.	 最后，最终；决定性地	
machine	[məˈʃi:n]	v.	 用机器加工	
text	[tekst]	n.	 正文，文本；原文；教科书	
contain	[kənˈtein]	v.	 包含，容纳；容忍，抑制；可被…除尽	
health	[helθ]	n.	 健康，健康状况；卫生	
cool	[ku:l]	v.	 使变凉	
audience	[ˈɔ:djəns]	n.	 听众，观众，读者；见面，会见	
sector	[ˈsektə]	n.	 部门，部分；防御地段，防区；扇形	
lecture	[ˈlektʃə]	n.	 演讲，讲课	
masculine	[ˈmɑ:skjulin]	adj.	 男性的，似男性的；［语法］阳性的	
ink	[iŋk]	n.	 墨水，油墨	
healthy	[ˈhelθi]	adj.	 健康的，健壮的；有益健康的，卫生的	
string	[striŋ]	v.	 缚，捆	
architecture	[ˈɑ:kitektʃə]	n.	 建筑，建筑学；建筑式样或风格，建筑物	
guard	[ɡɑ:d]	n.	 哨兵，警卫，看守	
many	[ˈmeni]	pron.	 许多人或物，许多	
comply	[kəmˈplai]	v.	 （with）遵照，照做，应允；顺从，服从	
minister	[ˈministə]	n.	 部长，大臣	
purple	[ˈpə:pl]	n.	 紫色	
myself	[maiˈself]	pron.	 [反身代词]我自己；我亲自	
layout	[ˈleiaut]	n.	 安排，布局，设计；规划图，布局图	
consult	[kənˈsʌlt]	v.	 请教，向…咨询，找…商量；查阅，查看	
safety	[ˈseifti]	n.	 安全，保险；安全设备，保险装置	
racket	[ˈrækit]	n.	 球拍	
indicative	[inˈdikətiv]	adj.	 指示的；象征的；暗示的	
o'clock	[əˈklɔk]	adv.	 （…）点钟（与1至12数字连用）	
basketball	[ˈbɑːskɪtbɔːl]	n.	 篮球，篮球运动	
scrap	[skræp]	v.	 废弃，报废	
shortcoming	[ˈʃɔ:tkʌmiŋ]	n.	 短处，缺点	
perplex	[pəˈpleks]	v.	 使困惑，使费解，使复杂化	
alongside	[əˈlɔŋˈsaid]	prep.	 在…的侧面；在…旁边	
condition	[kənˈdiʃən]	vt.	 决定；支配；训练	
diffuse	[diˈfju:s]	adj.	 （文章等）冗长的，漫无边际的	
robust	[rəuˈbʌst]	adj.	 强健的，雄壮的，精力充沛的，坚固的，浓的	
juvenile	[ˈdʒu:vinail]	adj.	 青少年的，幼稚的	
note	[nəut]	v.	 记下，摘下	
benefit	[ˈbenifit]	v.	 有益于；（from，by）受益	
via	[ˈvaiə]	prep.	 经；通过；凭借	
strict	[strikt]	adj.	 （with）严格的，严厉的；严谨的，精确的	
warmth	[wɔ:mθ]	n.	 暖和，温暖；热心，热情	
position	[pəˈziʃən]	n.	 位置；职位；姿势，姿态；见解，立场，形势	
interrupt	[ˌɪntəˈrʌpt]	v.	 中断，中止；打断（话），打扰	
clerk	[klɑ:k]	n.	 职员，办事员；店员	
clap	[klæp]	n.	 拍（手），掌声，霹雳声	
control	[kənˈtrəul]	v.	 控制，支配	
career	[kəˈriə]	n.	 （个人的）事业；专业，生涯，职业，经历	
future	[ˈfju:tʃə]	adj.	 将来的，未来的	
spouse	[spauz]	n.	 配偶（指夫或妻）	
welfare	[ˈwelfɛə]	n.	 福利；幸福；福利事业	
deliver	[diˈlivə]	v.	 交付，递送；发表，表达；释放；接生	
axe	[æks]	vt.	 用斧砍；解雇；削减	
disastrous	[diˈzɑ:strəs]	adj.	 灾难性的	
daily	[ˈdeili]	n.	 日报	
ignorance	[ˈiɡnərəns]	n.	 无知，愚昧；不知道	
contradiction	[ˌkɔntrəˈdikʃən]	n.	 反驳，否认；矛盾，不一致	
basket	[ˈbɑ:skit]	n.	 筐，篮，篓	
twelve	[twelv]	adj.	 十二（个，只…）的	
blaze	[bleiz]	v.	 燃烧，冒火焰	
rate	[reit]	v.	 估价；评级，评价	
virtual	[ˈvə:tjuəl]	adj.	 实际上的，事实上的	
merchandise	[ˈmə:tʃəndaiz]	n.	 商品，货物	
vehicle	[ˈvi:ɪkl]	n.	 车辆，交通工具；媒介，载体	
gather	[ˈɡæðə]	v.	 聚集，聚拢；推测，推断	
discern	[diˈsə:n]	v.	 认出，发现；辨别，识别	
dubious	[ˈdju:bjəs]	adj.	 怀疑的，无把握的；有问题的，靠不住的	
owner	[ˈəʊnə(r)]	n.	 物主，所有者	
ocean	[ˈəuʃən]	n.	 海洋	
school	[sku:l]	n.	 学校，学院；上学，学业；学派	
used	[ju:zd]	adj.	 旧的；习惯于…；过去经常	
thick	[θik]	adv.	 厚，浓，密	
entrance	[ˈentrəns]	n.	 入口，门口；进入；入学，入会	
sore	[sɔ:]	n.	 痛处，疮口	
undermine	[ˌʌndəˈmain]	v.	 暗中破坏，逐渐削弱；侵蚀…的基础	
hostile	[ˈhɔstail]	adj.	 敌对的，敌方的，敌意的	
bean	[bi:n]	n.	 豆；菜豆，蚕豆	
marriage	[ˈmæridʒ]	n.	 结婚，婚姻；结婚仪式	
merchant	[ˈmə:tʃənt]	n.	 商人，零售商	
link	[liŋk]	n.	 环节，链环	
fake	[feik]	v.	 伪造；伪装	
vote	[vəut]	v.	 投票，表决	
aggravate	[ˈæɡrəveit]	vt.	 加重，使恶化；激怒，使恼火	
active	[ˈæktiv]	adj.	 活跃的，敏捷的，积极的	
roar	[rɔ:]	n.	 吼叫，怒号；轰鸣，咆哮	
island	[ˈailənd]	n.	 岛，岛屿	
conviction	[kənˈvikʃən]	n.	 深信，确信；定罪，判罪	
usually	[ˈjuːʒuəli]	adv.	 通常，平常	
carpet	[ˈkɑ:pit]	n.	 地毯	
council	[ˈkaunsl]	n.	 理事会，委员会，议事机构	
hat	[hæt]	n.	 帽子（一般指有边的帽子）	
set	[set]	v.	 提出，调整，日落	
nowadays	[ˈnauədeiz]	adv.	 现今，现在	
brief	[bri:f]	v.	 简短介绍，简要汇报	
minute	[ˈminit]	adj.	 微小的	
ghost	[ɡəust]	n.	 鬼魂，幽灵	
strawberry	[ˈstrɔ:bəri]	n.	 草莓	
student	[ˈstju:dənt]	n.	 学生；研究者，学者	
expression	[iksˈpreʃən]	n.	 表达；表情；声调；腔调；榨出；措词；式；符号	
advocate	[ˈædvəkeit]	vt.	 拥护，提倡	
clinic	[ˈklinik]	n.	 诊所	
investigate	[inˈvestiɡeit]	v.	 调查，调查研究	
despatch	[disˈpætʃ]	n.	 急件；新闻报道	
weird	[wiəd]	adj.	 古怪的，离奇的；怪诞的，神秘而可怕的	
same	[seim]	adv.	 同样地	
persuasion	[pəˈsweiʒən]	n.	 说服，说服力	
foolish	[ˈfu:liʃ]	adj.	 愚笨的，愚蠢的	
color	[ˈkʌlə]	v.	 给…着色	
subjective	[sʌbˈdʒektiv]	adj.	 主观（上）的，个人的	
slave	[sleiv]	v.	 做苦工，拼命地干	
devise	[diˈvaiz]	vt.	 设计；发明；图谋；作出（计划）；想出（办法）	
torture	[ˈtɔ:tʃə]	n.	 拷问；折磨，痛苦	
envisage	[inˈvizidʒ]	v.	 想象，设想，展望，正视	
meditate	[ˈmedɪˌteɪt]	v.	 想，考虑，（尤指宗教上的）沉思，冥想	
radio	[ˈreidiəu]	v.	 无线电通讯	
identity	[aiˈdentiti]	n.	 身份；本体；特征；同一（性）；一致；国籍；等式	
nitrogen	[ˈnaitrədʒən]	n.	 [化]氮	
passive	[ˈpæsiv]	adj.	 被动的，消极的	
session	[ˈseʃən]	n.	 （一届）会议，一段时间	
earthquake	[ˈə:θkweik]	n.	 地震	
anger	[ˈæŋɡə]	vi.	 发怒	
invade	[inˈveid]	vt.	 入侵，侵略；涌入	
avail	[əˈveil]	n.	 [一般用于否定句或疑问句中]效用，利益	
face	[feis]	v.	 面对着；朝，面向	
beg	[beɡ]	vi.	 恳请，行乞	
cellar	[ˈselə]	n.	 地窑，地下室	
screen	[skri:n]	v.	 掩蔽，包庇；筛选拍摄；放映（电影）	
reflection	[riˈflekʃən]	n.	 （reflexion）映像，倒影；反省，沉思	
commission	[kəˈmiʃən]	n.	 委员会；委任，委托（书），代办；佣金，手续费	
blade	[bleid]	n.	 刀刃，刀片；桨叶；草叶，叶片	
explode	[iksˈpləud]	v.	 （使）爆炸，（使）爆发	
persuade	[pəˈsweid]	v.	 说服，劝说；（of）使相信	
port	[pɔ:t]	n.	 港口	
rug	[rʌɡ]	n.	 （小）地毯；围毯	
thought	[θɔ:t]	n.	 思想，思考；意图，打算；想法	
powder	[ˈpaudə]	n.	 粉末，药粉；火药，炸药	
bearing	[ˈbɛəriŋ]	n.	 轴承；忍受；关系，影响；举止；方向	
pistol	[ˈpistl]	n.	 手枪	
dock	[dɔk]	n.	 船坞，码头	
kilometre	[ˈkɪləmiːtə(r)]	n.	 （kilometer）公里，千米（略作km）	
peep	[pi:p]	v.	 偷看，窥视	
raw	[rɔ:]	adj.	 未煮过的，生的；未加工过的，未经训练的	
ill	[il]	adv.	 坏地；不利地	
maid	[meid]	n.	 少女，处女，女仆	
eye	[ai]	vt.	 看，审视	
tiresome	[ˈtaiəsəm]	adj.	 使人厌倦的，讨厌的	
regarding	[riˈɡɑ:diŋ]	prep.	 关于，有关	
impress	[imˈpres]	v.	 给…深刻印象；使钦佩；使铭记	
sly	[slai]	adj.	 狡猾的，偷偷摸摸的	
mute	[mju:t]	v.	 减弱…的声音	
claim	[kleim]	n.	 要求；断言；索赔；权利	
moment	[ˈməʊmənt]	n.	 片刻，瞬间，时刻	
traffic	[ˈtræfik]	n.	 交通，交通量	
enlighten	[inˈlaitən]	v.	 启发，启蒙，教导	
year	[jə:]	n.	 年，年度，学年	
postpone	[ˌpəustˈpəun]	v.	 推迟，延期	
recruit	[riˈkru:t]	n.	 新成员，新兵	
suffer	[	v.	 （from）受痛苦，患病；遭受；忍受	
wonder	[ˈwʌndə]	v.	 对…感到疑惑；（at）诧异；想知道	
dead	[ded]	adv.	 完全地	
handsome	[ˈhænsəm]	adj.	 漂亮的，英俊的；慷慨的，数量可观的	
geometry	[dʒiˈɔmitri]	n.	 几何（学）	
whether	[ˈhweðə]	conj.	 是否，会不会，不管，无论	
history	[ˈhistəri]	n.	 历史，历史学；来历，经历	
annoy	[əˈnɔi]	vi.	 招人讨厌	
ox	[ɔks]	n.	 牛，公牛	
teacher	[ˈti:tʃə]	n.	 教师（员），老（导）师	
boycott	[ˈbɔikɔt]	n.	 （联合）抵制，拒绝参与	
frequency	[ˈfri:kwənsi]	n.	 频率，周率	
cradle	[ˈkreidl]	n.	 摇篮；发源地	
overall	[ˈəuvərɔ:l]	n.	 （套头）工作服	
loyalty	[ˈlɔiəlti]	n.	 忠诚，忠心	
variation	[ˌveərɪˈeɪʃ(ə)n]	n.	 变化，变动；变种，变异	
information	[ˌɪnfəˈmeiʃən]	n.	 通知，报告；情报，资料，消息；信息	
price	[prais]	v.	 标价	
dial	[ˈdaiəl]	v.	 拨号，打电话	
defend	[diˈfend]	v.	 防守，保卫；为…辩护，为…答辩	
elevate	[ˈeliveit]	vt.	 举起，提拔，振奋，提升…的职位	
Christ	[kraist]	n.	 基督，救世主，耶稣	
lap	[læp]	n.	 大腿，（跑道的）一圈，一段路程，工作阶段	
rubber	[ˈrʌbə]	n.	 橡皮，橡胶；橡胶制品，胶鞋	
radical	[ˈrædikəl]	adj.	 基本的，重要的；激进的，极端的；根本的	
polite	[pəˈlait]	adj.	 有礼貌的，客气的；有教养的，文雅的	
observe	[əbˈzə:v]	v.	 观察，观测，注意到，监视，遵守，评述，说	
plane	[plein]	n.	 飞机；平面，水平面	
ice	[ais]	vt.	 冰冻，使成冰	
pity	[ˈpiti]	n.	 憾事，怜悯	
cosy	[ˈkəuzi]	adj.	 暖和舒服的；舒适的	
income	[ˈinkəm]	n.	 收入，收益，所得	
various	[ˈvɛəriəs]	adj.	 各种各样的；不同的	
word	[wə:d]	n.	 词语；言语；谈话；信息	
cabin	[ˈkæbin]	n.	 客舱，机舱；小（木）屋	
except	[ikˈsept]	v.	 除外；反对	
manipulate	[məˈnipjuleit]	vt.	 （熟练地）使用，操作；（巧妙地）处理	
costly	[ˈkɔstli]	adj.	 昂贵的，价值高的，豪华的	
global	[ˈɡləubəl]	adj.	 球形的；全球的，全世界的；全面的	
convince	[kənˈvins]	v.	 （of）使信服，使确信	
relationship	[riˈleiʃənʃip]	n.	 关系，联系	
tractor	[ˈtræktə]	n.	 拖拉机，牵引车	
series	[ˈsiəri:z]	n.	 一系列，连续；丛书	
kite	[kait]	n.	 风筝	
fuss	[fʌs]	n.	 紧张不安，大惊小怪	
psychology	[saiˈkɔlədʒi]	n.	 心理，心理学，心理状态	
rational	[ˈræʃənl]	adj.	 理性的，合理的	
too	[tu:]	adv.	 也，还；太，过于；很，非常	
lag	[læɡ]	v.	 用隔热材料覆盖；滞后	
fortnight	[ˈfɔ:tnait]	n.	 两星期	
mechanic	[miˈkænik]	n.	 技工，机修工	
vegetarian	[ˌvedʒɪˈteəri:ən]	n.	 素食主义者（的）	
drama	[ˈdrɑ:mə]	n.	 剧本，戏剧；戏剧性事件或场面	
skip	[skip]	vt.	 故意忽略；略过	
enough	[iˈnʌf]	adv.	 足够地	
though	[ðəu]	conj.	 尽管，虽然	
fall	[fɔ:l]	n.	 秋季	
temperament	[ˈtempərəmənt]	n.	 气质，性格，性情；资质	
pocket	[ˈpɔkit]	v.	 把…装入袋内	
painter	[ˈpeintə]	n.	 漆工，画家	
linear	[ˈlɪniə(r)]	adj.	 线的，直线的，线状的；长度的；线性的	
orange	[ˈɔrindʒ]	n.	 柑，桔子，橙子	
twist	[twist]	n.	 拧；歪曲；曲折	
brake	[breik]	v.	 制动（器），闸，刹车	
treasure	[ˈtreʒə]	v.	 珍爱，珍惜	
helicopter	[ˈhelikɔptə]	n.	 直升（飞）机	
disturbance	[disˈtə:bəns]	n.	 动乱，骚乱，干扰	
beneath	[biˈni:θ]	adv.	 在下方	
give	[ɡiv]	v.	 给，授予；供给；献出，让步；捐赠；发表	
diagnose	[ˈdaiəɡnəuz]	vt.	 诊断（疾病）；判断（问题）	
publicity	[pʌbˈlisiti]	n.	 公开，宣传，广告，公众的注意	
prayer	[prɛə]	n.	 祈祷，祷告，祷文	
barber	[ˈbɑ:bə]	n.	 理发师	
acre	[ˈeikə]	n.	 英亩；田地；地产	
whoever	[hu:ˈevə]	pron.	 [引导名词从句]谁；无论谁；究竟是谁	
contrast	[ˈkɔntræst]	vt.	 把…与…对比	
right	[rait]	adv.	 在右边，正确地	
explosion	[iksˈpləuʒən]	n.	 爆炸，爆发	
span	[spæn]	n.	 跨度，跨距	
blossom	[ˈblɔsəm]	vi.	 开花；展开；繁荣	
owe	[əu]	v.	 欠（债等），应向…付出，归功于，得感谢	
fertilizer	[ˈfə:tilaizə]	n.	 （fertiliser）肥料	
address	[əˈdres]	v.	 向…致词；寄往；向…说话	
serve	[sə:v]	v.	 服务，尽责；招待，侍候；符合，适用	
noisy	[ˈnɔizi]	adj.	 吵闹的，喧闹的	
guitar	[ɡiˈtɑ:]	vi.	 弹吉他	
foremost	[ˈfɔ:məust]	adv.	 首要地	
action	[ˈækʃən]	n.	 行动；作用；运转；行为；战斗	
begin	[biˈɡin]	v.	 开始，着手	
fume	[fju:m]	n.	 （浓烈或难闻的）烟，气，汽	
noble	[ˈnəubl]	n.	 贵族	
readily	[ˈredili]	adv.	 容易地；乐意地，欣然地	
police	[pəˈli:s]	v.	 管辖	
cigaret	[ˌsigəˈret]	n.	 （cigarette）香烟，纸烟，卷烟	
painting	[ˈpeintiŋ]	n.	 上油漆，着色；绘画；油画；画法	
autumn	[ˈɔ:təm]	n.	 秋，秋季；成熟期，渐衰期	
customary	[ˈkʌstəməri]	adj.	 习惯的，惯例的	
sprout	[spraut]	n.	 新芽，嫩苗	
permission	[pəˈmiʃən]	n.	 允许，同意	
ozone	[ˈəuzəun]	n.	 臭氧；（海岸等的）新鲜空气	
deadly	[ˈdedli]	adj.	 致命的；势不两立的；极度的；必定的	
noodle	[ˈnu:dl]	n.	 （常用复数）面条	
selfish	[ˈselfiʃ]	adj.	 自私的，利己的	
gap	[ɡæp]	n.	 缺口；差距；空白；缺乏	
revelation	[ˌrevəˈleiʃən]	n.	 揭示，揭露，显示，启示，新发现，被揭露的事	
bathe	[beið]	v.	 洗澡，游泳，浸，弄湿	
long	[lɔŋ]	adv.	 长久，长期地	
embassy	[ˈembəsi]	n.	 大使馆；大使及其随员	
thief	[θi:f]	n.	 （thieves）贼；小偷	
combine	[kəmˈbain]	v.	 集团；联合企业	
schedule	[ˈʃedju:əl]	v.	 安排，预定	
dense	[dens]	adj.	 浓厚的，密集的，稠密的	
harness	[ˈhɑ:nis]	n.	 马具，挽具	
spiral	[ˈspaiərəl]	v.	 螺旋上升；盘旋	
management	[ˈmænidʒmənt]	n.	 经营，管理；处理，操纵；管理部门	
bloody	[ˈblʌdi]	adj.	 流血的，血腥的	
fairy	[ˈfɛəri]	n.	 仙女；精灵	
writing	[ˈraitiŋ]	n.	 写，写作；著作，作品	
bacon	[ˈbeikən]	n.	 咸猪肉，熏猪肉	
hence	[hens]	adv.	 从此，今后；因此	
effort	[ˈefət]	n.	 努力；成就；艰难的尝试	
surround	[səˈraund]	n.	 环绕物	
political	[pəˈlitikəl]	adj.	 政治的	
include	[inˈklu:d]	v.	 包括，包含，计入	
rotten	[ˈrɔtən]	adj.	 腐烂的，腐朽的	
which	[hwitʃ]	adj.	 哪个，哪些；什么样的；那个，那些	
steam	[sti:m]	v.	 蒸发；蒸；用蒸汽开动	
volcano	[vɔlˈkeinəu]	n.	 火山	
penny	[ˈpeni]	n.	 便士，美分	
hammer	[ˈhæmə]	v.	 锤击，敲打	
succession	[səkˈseʃən]	n.	 连续，系列；继任，继承	
assembly	[əˈsembli]	n.	 集合；会议；装配；议会；代表大会	
ski	[ski:]	v.	 滑雪	
dean	[di:n]	n.	 （大学）院长；主持牧师；（基督教）教长	
soon	[su:n]	adv.	 不久，即刻；快，早	
lid	[lid]	n.	 盖	
acid	[ˈæsid]	adj.	 酸的，酸味的；尖刻的	
tool	[tu:l]	n.	 工具，用具；方法，手段	
ventilate	[ˈventileit]	vt.	 使通风；给…装通风设备	
third	[θɜ:d]	num.	 第三（个），三分之一（的）	
crab	[kræb]	n.	 螃蟹，蟹肉	
integrity	[inˈteɡriti]	n.	 正直，诚实；完整，完全	
lantern	[ˈlæntən]	n.	 灯，灯笼	
textbook	[ˈtekstbuk]	n.	 课本，教科书	
intrinsic	[inˈtrinsik]	adj.	 内在的；本身的；固有的	
Bible	[ˈbaɪbəl]	n.	 圣经	
thread	[θred]	v.	 穿线，穿过	
asset	[ˈæset]	n.	 资产，财产；有价值的物品；天赋	
insist	[inˈsist]	vi.	 （on）坚持要求，坚决主张，坚持	
function	[ˈfʌŋkʃən]	v.	 起作用	
groan	[ɡrəun]	v.	 呻吟	
timber	[ˈtimbə]	n.	 木材，木料	
contend	[kənˈtend]	v.	 竞争，斗争；坚决主张	
impression	[imˈpreʃən]	n.	 印象，感想；盖印，压痕	
external	[eksˈtə:nl]	adj.	 外部的；客观的；外国的；表面的；[医]外用的	
doze	[dəuz]	v.	 瞌睡；假寐	
happen	[ˈhæpən]	v.	 （偶然）发生；碰巧，恰好	
rap	[ræp]	v.	 敲，拍，打，斥责，使着迷	
carrier	[ˈkæriə]	n.	 搬运人；载体	
spark	[spɑ:k]	v.	 发火花，发电花	
cheque	[tʃek]	n.	 （check）支票，空白支票；总收入	
acquaintance	[əˈkweintəns]	n.	 认识，相识，了解；相识的人，熟人	
normalization	[ˌnɔ:məlaɪˈzeɪʃən]	n.	 （normalisation）正常化，标准化	
doctorate	[ˈdɔktərit]	n.	 博士学位；博士头衔	
undoubtedly	[ʌnˈdaʊtɪdli]	adv.	 无疑，必定	
example	[iɡˈzɑ:mpl]	n.	 例子，实例；模范，榜样	
direction	[diˈrekʃən]	n.	 方向，方位；指令，说明	
factor	[ˈfæktə]	n.	 因素，要素	
buy	[bai]	vi.	 购买东西	
tax	[tæks]	v.	 对…征税，使负重担	
wrinkle	[ˈriŋkl]	v.	 起皱，皱眉	
tame	[teim]	vt.	 驯服	
sentiment	[ˈsentimənt]	n.	 感情，柔情；看法；感觉	
parallel	[ˈpærəlel]	n.	 平行线，类似，对比	
pleasure	[ˈpleʒə]	n.	 愉快，快乐；乐事，乐趣	
impair	[imˈpɛə]	v.	 损害，损伤；削弱，减少	
confusion	[kənˈfju:ʒən]	n.	 困惑，糊涂；混淆；混乱，骚乱	
client	[ˈklaiənt]	n.	 律师等的当事人，委托人；商店的顾客	
tar	[tɑː(r)]	vt.	 涂或浇柏油、焦油于…	
stick	[stik]	v.	 刺，戳，扎；粘贴	
truth	[tru:θ]	n.	 真实，真相；真实性；真理	
blunder	[ˈblʌndə]	n.	 大错	
shiver	[ˈʃivə]	v.	 战栗，发抖	
ladder	[ˈlædə]	n.	 梯子，阶梯	
feudal	[ˈfju:dl]	adj.	 封建的；封地的；领地的	
pigeon	[ˈpidʒin]	n.	 鸽子	
wine	[wain]	n.	 葡萄酒，果酒	
palace	[ˈpælis]	n.	 宫，宫殿	
blackmail	[ˈblækmeil]	n.	 讹诈，敲诈，勒索；胁迫，恫吓	
left	[left]	adj.	 左边的，左面的；在左方的	
ridge	[ridʒ]	n.	 岭，山脉；屋脊；鼻梁	
dove	[dʌv]	n.	 鸽子	
injury	[ˈindʒəri]	n.	 伤害；损伤	
patience	[ˈpeiʃəns]	n.	 耐心，忍耐	
bunch	[bʌntʃ]	n.	 （一）簇，束，捆，串，一伙，一群	
element	[ˈelimənt]	n.	 元素；要素；成分；元件；自然环境	
outcome	[ˈautkʌm]	n.	 结果，成果	
bud	[bʌd]	v.	 发芽，含苞欲放	
passion	[ˈpæʃən]	n.	 热情，激情，爱好；激怒；强烈感情	
invitation	[ˌɪnviˈteiʃən]	n.	 邀请，招待；请柬	
fortune	[ˈfɔ:tʃən]	n.	 运气；命运；财产；财富	
launch	[lɔ:ntʃ]	n.	 发射，下水	
echo	[ˈekəʊ]	v.	 回声，反响，共鸣	
boom	[bu:m]	v.	 迅速发展，兴旺；发出隆隆声	
pail	[peɪl]	n.	 桶，提桶；一桶的量	
humid	[ˈhju:mɪd]	adj.	 湿的，湿气重的	
controversial	[ˌkɔntrəˈvə:ʃəl]	adj.	 引起争论的，有争议的	
fling	[fliŋ]	v.	 （用力地）扔，抛，丢	
article	[ˈɑ:tikl]	n.	 文章，论文；条款，条文；物件；冠词	
toward	[tɔ:d]	prep.	 （towards）朝，向；将近；对于；为了	
faint	[feint]	n.	 昏倒；昏晕	
prior	[ˈpraiə]	adj.	 优先的，在前的；（to）在…之前	
system	[ˈsistəm]	n.	 系统，体系；制度；方法，方式，步聚	
reason	[ˈri:zən]	v.	 推理，说服，辩论，讨论	
adult	[	adj.	 成年的，充分长成的，成熟的	
stress	[	vt.	 强调，重读	
copyright	[ˈkɔpirait]	n.	 版权（的）	
sheep	[ʃi:p]	n.	 （绵）羊；易受人摆布的人	
format	[ˈfɔ:mæt]	vt.	 设计；安排	
exquisite	[ˈekskwizit]	adj.	 优美的，高雅的，精致的；剧烈的，异常的	
room	[ru:m]	n.	 房间，室，空间，地方；余地	
attack	[əˈtæk]	n.	 攻击，抨击；进攻；（病）发作	
juice	[dʒu:s]	n.	 （水果等）汁，液	
adolescent	[ˌædəuˈlesnt]	adj.	 青春期的，青少年的	
intelligence	[inˈtelidʒəns]	n.	 聪颖；智慧；智力；智能	
assume	[əˈsju:m]	vt.	 假装；假定，设想；承担；呈现，采取	
fasten	[ˈfɑ:sən]	v.	 扎牢，使固定	
decorate	[ˈdekəreit]	v.	 装饰，装潢，布置	
altitude	[ˈæltitju:d]	n.	 高度，海拔	
proceed	[prəˈsi:d]	v.	 进行，继续下去；发生	
reckless	[ˈreklis]	adj.	 不注意的，大意的，卤莽的，不顾后果的	
cigar	[siˈɡɑ:]	n.	 雪茄烟	
pound	[paund]	v.	 （连续）猛击，（猛烈）敲打，捣碎	
clothe	[kləʊð]	v.	 （给…）穿衣，供给…衣服	
flow	[fləu]	n.	 流量，流速	
intensive	[inˈtensiv]	adj.	 加强的；集中的；密集的	
factory	[ˈfæktəri]	n.	 工厂	
enhance	[inˈhɑ:ns]	v.	 提高，增强	
fulfill	[fulˈfil]	v.	 （fulfil）完成，履行，实践，满足	
orthodox	[ˈɔ:θədɔks]	adj.	 传统的，正统的，习惯的，保守的，东正教的	
submerge	[səbˈmə:dʒ]	v.	 沉没，淹没；潜入	
overwhelming	[ˌəuvəˈhwelmiŋ]	adj.	 势不可挡的，压倒的	
ahead	[əˈhed]	adv.	 在前面（头）；向（朝）前；提前	
blunt	[blʌnt]	v.	 （使）钝；（使）迟钝	
sit	[sit]	vt.	 使就坐	
expedition	[ˌekspiˈdiʃən]	n.	 远征（队），探险（队）	
mechanical	[miˈkænikəl]	adj.	 机械的，由机构制成的；机械似的，呆板的	
tail	[teil]	vt.	 尾随，跟踪	
shoulder	[ˈʃəuldə]	v.	 肩负，承担	
legacy	[ˈleɡəsi]	n.	 遗产，遗赠；先人（或过去）留下的东西	
morning	[ˈmɔ:niŋ]	n.	 早晨，上午	
innumerable	[iˈnju:mərəbl]	adj.	 无数的，数不清的	
enquire	[inˈkwaiə]	v.	 询问，打听；调查	
insurance	[inˈʃuərəns]	n.	 保险；安全保证	
certainly	[ˈsə:tnli]	adv.	 一定，必定，无疑；当然，行	
devil	[ˈdevl]	n.	 魔鬼	
membership	[ˈmembəʃip]	n.	 会员资格，成员资格	
monster	[ˈmɔnstə]	n.	 怪物，妖怪，畸形的动植物	
get	[ɡet]	v.	 获得，得到；使，使得；变得，成为；到达	
hemisphere	[ˈhemiˌsfiə]	n.	 半球	
war	[wɔ:]	vi.	 作战	
nearly	[ˈniəli]	adv.	 差不多，几乎	
knee	[ni:]	n.	 膝，膝盖	
qualification	[ˌkwɔlifiˈkeiʃən]	n.	 资格，合格；限定，条件；合格证	
elevator	[ˈeliveitə]	n.	 电梯，升降机	
physics	[ˈfiziks]	n.	 物理（学）	
prosperity	[prɔsˈperiti]	n.	 繁荣，兴旺	
leap	[li:p]	n.	 跳跃，飞跃	
discover	[disˈkʌvə]	v.	 发现，显示	
tutor	[ˈtju:tə]	v.	 辅导；当导师；当家庭教师	
offend	[əˈfend]	v.	 犯罪，冒犯，违反，得罪，使…不愉快	
flood	[flʌd]	v.	 淹没，发大水，泛滥	
disturb	[diˈstə:b]	v.	 扰乱，妨碍，使不安	
worm	[wə:m]	n.	 虫，蠕虫	
bribe	[braib]	v.	 向…行贿，买通	
collection	[kəˈlekʃən]	n.	 收藏（品），收集（物）	
gossip	[ˈɡɔsip]	n.	 （说）闲话，闲聊	
area	[ˈɛəriə]	n.	 面积；地区，地域；领域，范围	
cabbage	[ˈkæbidʒ]	n.	 洋白菜，卷心菜	
loan	[ləun]	v.	 借出	
extension	[iksˈtenʃən]	n.	 延长；扩大；范围；大小；尺寸；电话分机	
hut	[hʌt]	n.	 小屋，棚屋	
weigh	[wei]	v.	 称…重量，称；重达；考虑，权衡	
foresee	[fɔ:ˈsi:]	v.	 预见，预知	
restless	[ˈrestlis]	adj.	 得不到休息的；不平静的；坐立不安的	
exclusive	[iksˈklu:siv]	adj.	 独占的；孤高的；唯一的；高级的，奢华的	
dear	[diə]	int.	 呵！哎呀！	
former	[ˈfɔ:mə]	pron.	 前者	
dentist	[ˈdentist]	n.	 牙医	
oxygen	[ˈɔksidʒən]	n.	 氧，氧气	
ceremony	[ˈseriməni]	n.	 典礼，仪式；礼节，礼仪	
hers	[hə:z]	pron.	 （she的物主代词）她的（所有物）	
primary	[ˈpraiməri]	adj.	 最初的，初级的；首要的，主要的，基本的	
reciprocal	[riˈsiprəkəl]	adj.	 相互的，往复的，互利的	
privilege	[ˈprivilidʒ]	v.	 给予优惠，给予特权	
amount	[əˈmaunt]	v.	 共计；等同，接近（to）	
problem	[ˈprɔbləm]	n.	 问题，疑难问题；思考题，讨论题	
consensus	[kənˈsensəs]	n.	 （意见等的）一致，一致同意，共识	
pitch	[pitʃ]	v.	 用沥青覆盖；投掷，扔	
plural	[ˈpluərəl]	n.	 复数	
monthly	[ˈmʌnθli]	n.	 月刊	
curse	[kə:s]	vt.	 诅咒，咒骂，使受罪	
comic	[ˈkɔmik]	n.	 连环漫画杂志；喜剧演员	
niece	[ni:s]	n.	 侄女，甥女	
believe	[biˈli:v]	vi.	 相信，信任，信奉	
migrate	[maiˈɡreit]	v.	 迁移，移居（国外）	
February	[ˈfebruəri]	n.	 二月	
escort	[ˈeskɔ:t]	n.	 警卫，护送者；仪仗兵	
feasible	[ˈfi:zəbl]	adj.	 可行的；切实可行的；行得通的；可用的	
stride	[straid]	n.	）长足进步	
match	[mætʃ]	v.	 匹配，相称	
poll	[pəul]	v.	 获得…选票	
emperor	[ˈempərə]	n.	 皇帝	
brochure	[ˈbrəuʃuə]	n.	 小册子	
infectious	[inˈfekʃəs]	adj.	 传染的，传染性的，有感染力的	
seminar	[ˈseminɑ:]	n.	 研究班，研讨会	
airline	[ˈɛəlain]	adj.	 （飞机）航线的	
sideways	[ˈsaidweiz]	adv.	 向旁边（的），侧身，横着（的），斜着（的）	
restore	[riˈstɔ:]	v.	 恢复，归还，交还；修复，重建	
visit	[ˈvizit]	v.	 访问，参观；视察；降临；闲谈	
lobby	[ˈlɔbi]	n.	 门廊，门厅，（会议）休息厅	
lonely	[ˈləunli]	adj.	 孤独的，寂寞的；荒凉的，人迹稀少的	
cat	[kæt]	n.	 猫；猫科	
upward	[ˈʌpwəd]	adv.	 向上	
ninety	[ˈnaɪnti:]	num.	 九十，九十个	
rear	[riə]	v.	 饲养，抚养，栽培，举起	
locate	[ləuˈkeit]	v.	 查出，探出，查找…地点，使…坐落于，位于	
endure	[inˈdjuə]	v.	 忍受，持久，持续	
occur	[əˈkə:]	v.	 发生，出现；存在；想起，想到	
confine	[kənˈfain]	n.	 界限，范围	
the	[ðə]	art.	 这（那）个；这（那）些（指特定的人或物）	
grain	[ɡrein]	n.	 谷物，谷类；颗粒，细粒	
advice	[ədˈvais]	n.	 劝告，忠告，（医生等的）意见	
nest	[nest]	v.	 筑巢	
conservative	[kənˈsə:vətiv]	n.	 保守主义者	
reject	[riˈdʒekt]	n.	 落选者	
refuge	[ˈrefju:dʒ]	n.	 避难处，藏身处	
additional	[əˈdɪʃənl]	adj.	 额外的，附加的，另外的	
shoe	[ʃu:]	n.	 鞋	
gun	[ɡʌn]	n.	 枪，炮，手枪	
pretext	[ˈpri:tekst]	n.	 借口，托词	
poultry	[ˈpəultri]	n.	 家禽	
elbow	[ˈelbəu]	vt.	 用肘推，用肘挤	
chest	[tʃest]	n.	 胸腔，胸膛；箱，柜	
slum	[slʌm]	n.	 贫民窟，贫民区，陋巷	
shirt	[ʃə:t]	n.	 衬衫	
evaluate	[iˈvæljueit]	v.	 估价，评价；求…的值	
ordinary	[ˈɔ:dinəri]	adj.	 普通的，平凡的，平常的；平庸的	
refute	[riˈfju:t]	v.	 反驳，驳斥	
bypass	[ˈbaipɑ:s]	vt.	 绕过	
critic	[ˈkritik]	n.	 批评家，评论家	
dozen	[ˈdʌzn]	n.	 一打，十二个	
carrot	[ˈkærət]	n.	 胡萝卜	
limp	[limp]	v.	 蹒跚，跛行	
shabby	[ˈʃæbi]	adj.	 简陋的，破旧的，卑鄙的，不公平的	
goat	[ɡəut]	n.	 山羊	
plus	[plʌs]	n.	 加号，正号	
casual	[ˈkæʒjuəl]	adj.	 偶然的；临时的；非正式的；随意的	
bulk	[bʌlk]	n.	 体积，容积；主体，大批，大量，大块	
mistress	[ˈmistris]	n.	 女主人；主妇；情妇，情人	
put	[put]	vt.	 放，搁，置；表达；使处于…状态，记下	
fertile	[ˈfə:tail]	adj.	 肥沃的，富饶的；能繁殖的	
impatient	[imˈpeiʃənt]	adj.	 不耐烦的，急躁的	
quiet	[ˈkwaiət]	v.	 使安静，平静	
bull	[bul]	n.	 公牛	
infect	[inˈfekt]	vt.	 传染，感染；影响（思想等）	
discriminate	[disˈkrimineit]	v.	 区别，辨别；（against）有差别地对待，歧视	
urban	[ˈə:bən]	adj.	 城市的，市内的	
execute	[ˈeksikju:t]	v.	 实行；实施；执行；完成；履行；处死	
vase	[vɑ:z]	n.	 花瓶，瓶	
conflict	[ˈkɔnflikt]	v.	 （with）抵触，冲突	
elite	[eiˈli:t]	n.	 [集合名词]精华；精锐；中坚分子	
govern	[ˈɡʌvən]	v.	 统治，管理；决定，支配	
friend	[frend]	n.	 朋友	
since	[sins]	adv.	 后来	
intermediate	[ˌɪntəˈmi:djət]	n.	 中间体，媒介物	
invite	[inˈvait]	v.	 邀请；请求；招致	
deliberate	[diˈlibərit]	vt.	 研讨，商讨	
rock	[rɔk]	v.	 摇，摇动	
if	[if]	conj.	 （用于连接宾语从句）是否；是不是	
trash	[træʃ]	n.	 垃圾；拙劣的作品；渣滓，败类	
breakdown	[ˈbreikdaun]	n.	 崩溃；衰竭；（关系、计划或讨论等）中断	
tribute	[ˈtribju:t]	n.	 贡品；颂词，称赞，礼物	
seldom	[ˈseldəm]	adv.	 很少，不常	
coalition	[ˌkəuəˈliʃən]	n.	 结合体，同盟；结合，联合	
upset	[ʌpˈset]	adj.	 难过的；不安的	
trip	[trip]	v.	 绊倒；失足；犯错	
complain	[kəmˈplein]	v.	 （about，of）抱怨；申诉	
view	[vju:]	vt.	 观察；认为	
nephew	[ˈnefju:]	n.	 侄子，外甥	
gaze	[ɡeiz]	v.	 凝视，注视	
nod	[nɔd]	n.	 点头招呼；打盹，瞌睡	
rod	[rɔd]	n.	 杆，棒	
journal	[ˈdʒə:nl]	n.	 定期刊物，杂志，日报；日志，日记	
bounce	[bauns]	n.	 弹力，弹性	
sometimes	[ˈsʌmtaimz]	adv.	 不时，有时，间或	
verb	[və:b]	n.	 动词	
frustrate	[ˈfrʌstreit]	vt.	 挫败，阻挠，使灰心	
cathedral	[kəˈθi:drəl]	n.	 大教堂	
degree	[diˈɡri:]	n.	 程度；度数；学位；等级	
meeting	[ˈmi:tiŋ]	n.	 会议，集合，汇合，会见，接见，汇合点	
reply	[riˈplai]	v.	 （to）回答，答复，以…作答	
practical	[ˈpræktikəl]	adj.	 实际的，实用的	
soldier	[ˈsəuldʒə]	n.	 士兵，军人	
spot	[spɔt]	v.	 认出，认清，发现；玷污，弄脏	
progress	[ˈprəuɡres]	v.	 进步，进展；前进	
state	[steit]	v.	 陈述，说明	
professional	[prəˈfeʃənəl]	n.	 自由职业者，专业人员	
heal	[hi:l]	v.	 治愈，愈合	
railroad	[ˈreilrəud]	v.	 由铁道运输；强迫	
pest	[pest]	n.	 害虫	
symposium	[simˈpəuziəm]	n.	 讨论会，专题报告会；专题论文集	
surgery	[ˈsə:dʒəri]	n.	 外科，外科学；手术室，诊疗室	
cue	[kju:]	n.	 暗示，提示	
ample	[ˈæmpl]	adj.	 充分的，富裕的；宽敞的，宽大的	
retreat	[riˈtri:t]	v.	 撤退，退却	
improve	[imˈpru:v]	v.	 改善，改进，增进；好转，进步	
spell	[spel]	v.	 拼写	
misery	[ˈmizəri]	n.	 痛苦，悲惨，不幸	
baggage	[ˈbæɡidʒ]	n.	 行李	
delicious	[diˈliʃəs]	adj.	 美味的；美妙的；使人愉快的	
tide	[taid]	n.	 潮，潮汐；潮流，趋势	
split	[split]	n.	 分化，分裂，裂口	
waterproof	[ˈwɔ:təpru:f]	adj.	 防水的，耐水的	
piano	[piˈænəu]	n.	 钢琴	
detective	[diˈtektiv]	n.	 侦探	
tear	[tiə]	n.	 破裂	
afraid	[əˈfreid]	adj.	 害怕的，恐惧的；犯愁的，不乐意的	
forth	[fɔ:θ]	adv.	 向前；向外，往外	
voltage	[ˈvəʊltɪdʒ]	n.	 电压	
divine	[diˈvain]	adj.	 神的，神授的，天赐的；极好的，极美的	
gallery	[ˈɡæləri]	n.	 长廊，画廊，美术馆	
fifty	[ˈfɪfti:]	num.	 五十，五十个	
garbage	[ˈɡɑ:bidʒ]	n.	 垃圾；无用的数据	
purse	[pə:s]	n.	 钱包	
stereotype	[ˈsteriəˌtaɪp]	vt.	 使定型，使模式化	
enable	[iˈneibl]	v.	 使能够，使成为可能；授予权利或方法	
impose	[imˈpəuz]	v.	 征（税）；（on）把…强加给	
misfortune	[misˈfɔ:tʃən]	n.	 不幸，灾祸，灾难	
business	[ˈbiznis]	n.	 商业，生意；事务，业务，职责	
revenue	[ˈrevənju:]	n.	 财政收入，税收	
pardon	[ˈpɑ:dən]	v.	 原谅，饶恕，赦免	
reflect	[riˈflekt]	v.	 反射，反映，表现，反省，沉思	
index	[ˈindeks]	v.	 附以索引	
gamble	[ˈɡæmbl]	n.	 投机，冒险；赌博	
instruct	[inˈstrʌkt]	v.	 教，教授；命令，指示	
sweep	[swi:p]	v.	 扫，打扫；席卷，冲光；扫过，掠过	
priest	[pri:st]	n.	 教士，神父	
bad	[bæd]	adj.	 坏的；低劣的；不舒服的；严重的	
clip	[klip]	n.	 夹，钳；回形针	
phrase	[freiz]	n.	 短语，词语，习语	
available	[əˈveiləbl]	adj.	 （用于物）可用的；可见到的，接受采访的	
outline	[ˈautlain]	v.	 概述，略述	
magnet	[ˈmæɡnit]	n.	 磁体，磁铁	
county	[ˈkaunti]	n.	 （英国）郡，（美国）县	
language	[ˈlæŋɡwidʒ]	n.	 语言，术语，（运用语言的）方式、风格	
ministry	[ˈministri]	n.	 （政府的）部；牧师	
alloy	[ˈælɔi]	vt.	 将…铸成合金；使降低	
punch	[pʌntʃ]	v.	 冲压，穿孔	
remainder	[riˈmeində]	n.	 剩余物，剩下的；余数，余项	
pronunciation	[prəˌnʌnsiˈeiʃən]	n.	 发音，发音方法	
carve	[kɑ:v]	v.	 （雕）刻	
better	[ˈbetə]	n.	 较佳者	
estimate	[ˈestəˌmeit]	v.	 估计，估价；评估	
analytic	[ˌænəˈlɪtɪk]	adj.	 （analytical）分析的；分解的	
elastic	[iˈlæstik]	n.	 松紧带，橡皮圈	
kidney	[ˈkidni]	n.	 肾，肾脏	
yell	[jel]	n.	 叫声；喊声	
narrow	[ˈnærəu]	adj.	 狭窄的，狭的，狭隘的	
incline	[inˈklain]	n.	 斜坡，斜面	
graduate	[ˈɡrædjuit]	adj.	 毕了业的	
twinkle	[ˈtwɪŋkəl]	n.	 闪烁，闪光	
treaty	[ˈtri:ti]	n.	 条约，协议，协商	
butcher	[ˈbutʃə]	n.	 屠夫，卖肉者；刽子手	
not	[nɔt]	adv.	 不，不是，不会；没有	
new	[nju:]	adj.	 新（近）的；新来的；不熟悉的；没经验的	
herb	[hə:b]	n.	 药草，（调味用的）香草，草本植物	
dilemma	[diˈlemə]	n.	 （进退两难的）窘境，困境	
tragedy	[ˈtrædʒidi]	n.	 悲剧；惨事，灾难	
monetary	[ˈmʌnitəri]	adj.	 金融的，货币的	
catastrophe	[kəˈtæstrəfi]	n.	 大灾难；（悲剧）结局	
feeling	[ˈfi:liŋ]	n.	 感情；心情；知觉；同情	
tie	[tai]	v.	 扎，系，捆	
town	[taun]	n.	 市镇；市民；城市商业区，闹市区	
enlarge	[inˈlɑ:dʒ]	vt.	 扩大，放大，增大	
preposition	[ˌprepəˈziʃən]	n.	 介词	
sensation	[senˈseiʃən]	n.	 感觉，知觉；激动，轰动，轰动一时的事情	
obey	[əuˈbei]	v.	 服从，顺从	
fever	[ˈfi:və]	n.	 发热，狂热	
erupt	[iˈrʌpt]	v.	 （尤指火山）爆发	
rotate	[rəuˈteit]	v.	 （使）旋转	
comrade	[ˈkɔmrid]	n.	 同志，同事，同伴，朋友	
portray	[pɔ:ˈtrei]	v.	 描写，描述；画（人物、景象等）	
hose	[həʊz]	v.	 用软管（淋浇，冲洗）	
snatch	[snætʃ]	n.	 攫取，抢夺	
semiconductor	[ˌsemikənˈdʌktə]	n.	 半导体	
book	[buk]	vt.	 订（票，座位，房间等），预定	
oil	[ɔil]	v.	 给…加润滑油；涂油，上油	
proud	[praud]	adj.	 （of）自豪的；引以自豪的；妄自尊大的	
chemical	[ˈkemikəl]	n.	 化学制品，化学药品	
produce	[prəˈdju:s]	n.	 产品	
epidemic	[ˌepiˈdemik]	n.	 流行病；传播	
conjunction	[kənˈdʒʌŋkʃən]	n.	 接合，连接，联合；连（接）词	
essential	[iˈsenʃəl]	n.	 本质；要素	
urgent	[ˈə:dʒənt]	adj.	 急迫的，紧要的，紧急的	
revolt	[riˈvəult]	v.	 反抗，起义	
auction	[ˈɔ:kʃən]	n.	 拍卖	
cooperate	[kəuˈɔpəreit]	v.	 （with）合作，协作，相配合	
who	[hu:]	pron.	 谁，什么人；…的人	
wax	[wæks]	v.	 打蜡	
musical	[ˈmju:zikəl]	n.	 音乐片	
ugly	[ˈʌɡli]	adj.	 丑陋的，难看的；丑恶的，讨厌的	
boy	[bɔi]	n.	 男孩子，儿子；男性服务员	
collaborate	[kəˈlæbəˌreɪt]	vi.	 协作，合作；（与敌人）勾结	
ours	[ˈauəz]	pron.	 [we的物主代词]我们的（所有物）	
tale	[teil]	n.	 故事，传说	
aeroplane	[ˈɛərəplein]	n.	 （airplane）（英）飞机	
rival	[ˈraivəl，ˈraɪvl]	adj.	 竞争的	
pack	[pæk]	n.	 包裹，背包，一群/副	
write	[rait]	v.	 写，书写，写字；写作；写信（给），函告	
adopt	[əˈdɔpt]	vt.	 采用，采取（态度等）；选定；收养	
thigh	[θai]	n.	 大腿；股骨	
sober	[ˈsəubə]	adj.	 清醒的；认真的，冷静的，适度的	
mistake	[misˈteik]	v.	 弄错；（for）把…误认为	
tile	[tail]	vt.	 铺瓦于，贴砖于	
toilet	[ˈtɔilit]	n.	 厕所，盥洗室	
reach	[ri:tʃ]	n.	 能达到的范围	
transmission	[trænzˈmiʃən]	n.	 播送，发射；传动，传送	
liner	[ˈlainə]	n.	 班机，定期轮船，邮船	
kiss	[kis]	n.	 吻，接吻	
ham	[hæm]	n.	 火腿	
malignant	[məˈliɡnənt]	adj.	 恶性的，致命的；恶意的，恶毒的	
religion	[riˈlidʒən]	n.	 宗教，信仰	
perfection	[pəˈfekʃən]	n.	 尽善尽美，完美	
mean	[mi:n]	n.	 平均值	
dull	[dʌl]	adj.	 单调的；迟钝的，愚笨的；沉闷的	
thin	[θin]	v.	 变薄；变稀	
farmer	[ˈfɑ:mə]	n.	 农民，农场主	
perform	[pəˈfɔ:m]	v.	 履行，执行；表演，演出；完成（事业）	
delivery	[diˈlivəri]	n.	 递送；交付；分娩；交货；引渡	
click	[klik]	vi.	 发出滴答声	
mobile	[ˈməubail]	adj.	 可动的，活动的，运动的	
champion	[ˈtʃæmpjən]	n.	 冠军，得胜者；拥护者，斗士	
dependent	[diˈpendənt]	adj.	 依靠的，依赖的，从属的；随…而定的	
blame	[bleim]	n.	 责任，过错；责备	
scarf	[skɑ:f]	n.	 围巾，头巾，领巾，领带	
inner	[ˈinə]	adj.	 内部的，里面的；内心的	
trust	[trʌst]	n.	 （in）信任，依赖；委托	
silly	[ˈsili]	adj.	 傻的，糊涂的，愚蠢的	
dental	[ˈdentəl]	adj.	 牙齿的；牙科（用）的	
inertia	[iˈnə:ʃjə]	n.	 不活动，惰性；惯性	
steer	[stiə]	vi.	 驾驶，进行	
wind	[wind]	v.	 转动；缠绕；上发条；蜿蜒而行；使气急	
academic	[ˌækəˈdemik]	adj.	 学院的，大学的；学术性的；理论的	
funeral	[ˈfju:nərəl]	n.	 丧葬，葬礼	
approach	[əˈproʊtʃ]	n.	 接近；途径，入门；方式，方法	
scarcely	[ˈskɛəsli]	adv.	 几乎不，简直没有，勉强	
offspring	[ˈɔfspriŋ]	n.	 子孙，后代；结果，产物	
resort	[rɪˈzɔːt]	n.	 度假胜地，常去之处，手段	
plunge	[plʌndʒ]	v.	 （into）（使）投入，（使）插进，陷入；猛冲	
deprive	[diˈpraiv]	vt.	 剥夺，夺去，使丧失	
torrent	[ˈtɔrənt]	n.	 激流，洪流；爆发，（话语等的）连发	
continuous	[kənˈtinjuəs]	adj.	 连续的，持续的	
locomotive	[ˈləukəˌməutiv]	adj.	 运动的，移动的，运载的	
mere	[miə]	adj.	 纯粹的；仅仅，只不过	
dash	[dæʃ]	n.	 破折号；短跑；猛冲，冲撞	
meal	[mi:l]	n.	 膳食，一餐	
zebra	[ˈzi:brə]	n.	 斑马	
efficient	[iˈfiʃənt]	adj.	 有效的，效率高的；有能力的，能胜任的	
daughter	[ˈdɔ:tə]	n.	 女儿	
absurd	[əbˈsə:d]	adj.	 荒谬的，荒诞的，荒唐可笑的；不合理的	
beside	[biˈsaid]	prep.	 在…旁边，在…附近；和…相比	
enforce	[inˈfɔ:s]	v.	 实施，执行；强制；支持，坚持（要求，主张等）	
sauce	[sɔ:s]	n.	 酱汁，调味汁	
translation	[trænsˈleiʃən]	n.	 翻译；译文，译本	
shorthand	[ˈʃɔ:thænd]	n.	 速记	
itself	[itˈself]	pron.	 （it的反身代词）它自己，它本身	
hire	[ˈhaiə]	n.	 雇用，租借	
remain	[riˈmein]	v.	 剩下，余留；留待，尚须；仍然是，依旧是	
scrutiny	[ˈskru:tini]	n.	 周密的调查；仔细看；监视；选票复查	
breeze	[bri:z]	vi.	 来去匆匆，急速走；吹微风	
craft	[krɑ:ft]	n.	 工艺，手艺，技巧；飞机，飞船	
dwarf	[dwɔ:f]	vt.	 使…矮小	
front	[frʌnt]	v.	 面对	
democracy	[diˈmɔkrəsi]	n.	 民主，民主制，民主国家	
obsolete	[ˌɔbsəˈli:t]	adj.	 已废弃的，过时的	
anecdote	[ˈænikdəut]	n.	 轶事，趣闻，短故事	
balcony	[ˈbælkəni]	n.	 阳台；（电影院等的）楼厅，楼座	
jargon	[ˈdʒɑ:ɡən]	n.	 行话	
brass	[brɑ:s]	n.	 黄铜，铜器；铜管乐器	
bitter	[ˈbitə]	adj.	 （有）苦（味）的；痛苦的，厉害的	
spiritual	[ˈspiritʃuəl]	adj.	 精神（上）的，心灵的	
especially	[isˈpeʃəli]	adv.	 特别，尤其，格外；专门地，主要地	
amuse	[əˈmju:z]	vt.	 逗乐，使…消遣；引人发笑	
virgin	[ˈvə:dʒin]	adj.	 处女的；纯洁的；原始的；未使用的	
lady	[ˈleidi]	n.	 女士，夫人	
sparkle	[ˈspɑ:kl]	v.	 发火花，闪耀	
notice	[ˈnəutis]	v.	 注意到，注意	
umbrella	[ʌmˈbrelə]	n.	 伞	
camel	[ˈkæməl]	n.	 骆驼	
forbid	[fəˈbid]	v.	 禁止，不许	
mark	[mɑ:k]	v.	 标记，打分，使有特色	
rip	[rip]	n.	 裂口，裂缝	
cordial	[ˈkɔ:djəl]	adj.	 诚恳的，亲切的，热诚的	
grease	[ɡri:s]	v.	 抹油，润滑	
bomb	[bɔm]	v.	 投弹于，轰炸	
arise	[əˈraiz]	v.	 出现，发生；（from）由…引起，由…产生	
feature	[ˈfi:tʃə]	v.	 以…为特色	
punish	[ˈpʌniʃ]	v.	 惩罚，处罚	
technician	[tekˈniʃən]	n.	 技术员，技师，技工	
order	[ˈɔ:də]	v.	 定制，订购；命令	
guide	[ɡaid]	v.	 领路；指导；支配；管理	
extinct	[iksˈtiŋkt]	adj.	 灭绝的；熄灭了的	
amiable	[ˈeimjəbl]	adj.	 和蔼可亲的，友善的，亲切的	
motivate	[ˈməutiveit]	vt.	 促动；激励，鼓励，作为…的动机	
nourish	[ˈnʌriʃ]	v.	 提供养分，养育，怀有（希望，仇恨等）	
swell	[swel]	n.	 肿胀；膨胀；增大；增加	
hike	[haik]	vt.	 提高	
deadline	[ˈdedlain]	n.	 最后期限	
faulty	[ˈfɔ:lti]	adj.	 有错误的，有缺点的，不完善的	
accomplish	[əˈkɔmpliʃ]	v.	 实现（计划等）；达到（目的）；完成（任务）	
prohibit	[prəˈhibit]	v.	 禁止，不准；阻止	
customer	[ˈkʌstəmə]	n.	 顾客，主顾	
telescope	[ˈteliskəup]	v.	 缩短，压缩	
be	[bi:]	v.	 是，等于；（存）在；到达，来到，发生	
so	[səʊ]	adj.	 （贬）所谓的，号称的	
specify	[ˈspesifai]	v.	 指定，详细说明	
beer	[biə]	n.	 啤酒	
pen	[pen]	vt.	 写；关入栏中	
surgeon	[ˈsə:dʒən]	n.	 外科医生	
corporation	[ˌkɔːpəˈreɪʃn]	n.	 市镇自治机关；法人；公司，企业	
tent	[tent]	n.	 帐篷	
bully	[ˈbuli]	vt.	 威胁，欺侮	
contaminate	[kənˈtæmineit]	v.	 弄污，弄脏，毒害，传染，污染	
village	[ˈvilidʒ]	n.	 村，村庄	
cognitive	[ˈkɔɡnitiv]	adj.	 认知的，认识能力的	
guarantee	[ˌɡærənˈti:]	v.	 保证，担保	
preclude	[priˈklu:d]	v.	 排除，阻止，妨碍	
adore	[əˈdɔ:]	vt.	 崇拜，敬慕，爱慕；非常喜欢	
hierarchy	[ˈhaiərɑ:ki]	n.	 等级制度；统治集团，领导层	
appoint	[əˈpɔint]	vt.	 任命，委派；指定，约定（时间、地点等）	
stool	[stu:l]	n.	）大便	
victim	[ˈviktim]	n.	 牺牲品，受害者	
inverse	[ɪnˈvɜ:s	v.	 倒转	
eliminate	[iˈlimineit]	vt.	 除去；淘汰；排（删，消）除；削减（人员）	
renaissance	[riˈneisns]	n.	 文艺复兴（时期）；新生，复兴	
essence	[ˈesns]	n.	 本质，实质	
opera	[ˈɔpərə]	n.	 歌剧	
rid	[rid]	v.	 （of）使摆脱，使去掉	
line	[lain]	v.	 排队；加衬	
her	[hə:]	pron.	 [she的宾格]她；[she的所有格]她的	
eighty	[ˈeɪti:]	adj.	 八十（个，只…）的	
uncle	[ˈʌŋkl]	n.	 伯父，叔父，舅父，姑父，姨父	
bat	[bæt]	n.	 球拍，球棒，短棒；蝙蝠	
accurate	[ˈækjurit]	adj.	 正确无误的；准确的，精确的	
chicken	[ˈtʃikin]	n.	 鸡肉；鸡，小鸡，小鸟	
fix	[fiks]	n.	 困境	
curl	[kə:l]	n.	 卷发；卷曲状；卷曲物	
stagger	[ˈstæɡə]	n.	 摇晃不稳的动作；蹒跚	
enrich	[inˈritʃ]	v.	 使富足；使肥沃；装饰；加料于；浓缩	
vocal	[ˈvəukəl]	n.	 元音；声乐作品	
theoretical	[ˌθiəˈretikəl]	adj.	 理论（上）的	
flap	[flæp]	v.	 拍打，拍动	
linguistic	[liŋˈɡwistik]	adj.	 语言的，语言学的	
spectrum	[ˈspektrəm]	n.	 光谱，频谱；范围，幅度，系列	
confidence	[ˈkɔnfidəns]	n.	 （in）信任；信心，自信；秘密，机密	
picnic	[ˈpiknik]	v.	 （去）野餐	
sausage	[ˈsɔsidʒ]	n.	 香肠，腊肠	
wallet	[ˈwɔlit]	n.	 皮夹，钱包	
vowel	[ˈvaʊəl]	n.	 元音，元音字母	
contribute	[kənˈtribjut]	v.	 （to）贡献，捐助，捐献；投稿	
kitchen	[ˈkitʃin]	n.	 厨房	
engineer	[ˌendʒiˈniə]	n.	 工程师	
preference	[ˈprefərəns]	n.	 （for，to）偏爱，喜爱；优惠；优先选择	
flavor	[ˈfleɪvə]	v.	 给…调味	
utter	[ˈʌtə]	adj.	 彻底的，完全的	
anguish	[ˈæŋɡwiʃ]	n.	 （尤指心灵上的）极度痛苦，烦恼	
exam	[iɡˈzæm]	n.	 （examination）考试，测验	
parameter	[pəˈræmitə]	n.	 参数，参量	
roof	[ru:f]	n.	 屋顶，顶	
generation	[ˌdʒenəˈreiʃən]	n.	 生殖；产生，发生；一代（人）	
solution	[səˈlu:ʃən]	n.	 解答，解决办法；溶解，溶液	
music	[ˈmju:zik]	n.	 音乐，乐曲，乐谱	
alcohol	[ˈælkəˌhɔl]	n.	 酒精，乙醇；含酒精的饮料	
glide	[ɡlaid]	n.	 溜，滑行；（时间）消逝	
skilled	[skild]	adj.	 （in）熟练的，有技能的；需要技能的	
typhoon	[taiˈfu:n]	n.	 台风	
invisible	[inˈvizəbl]	adj.	 看不见的；隐形的	
grave	[ɡreiv]	adj.	 严肃的，庄重的	
instantaneous	[ˌɪnstənˈteinjəs]	adj.	 瞬间的，即刻的	
judge	[dʒʌdʒ]	vt.	 审判；评论，裁判	
solidarity	[ˌsɔliˈdæriti]	n.	 团结；休戚相关	
taxi	[ˈtæksi]	v.	 [指飞机]（使）滑行	
outward	[ˈautwəd]	n.	 外表	
dorm	[dɔ:m]	n.	 宿舍	
concept	[ˈkɔnsept]	n.	 概念，观念，设想	
shopkeeper	[ˈʃɔpˌki:pə]	n.	 店主	
politics	[ˈpɔlitiks]	n.	 政治，政治学；政纲，政见	
escape	[isˈkeip]	v.	 逃跑；避开，避免	
commit	[kəˈmit]	v.	 把…交托给，提交；犯（错误），干（坏事）	
coal	[kəul]	n.	 煤，煤块	
widespread	[ˈwaidspred]	adj.	 分布广泛的，普遍的	
snack	[snæk]	n.	 快餐，小吃，点心	
backward	[ˈbækwəd]	adv.	 向后，朝反方向	
retrieve	[riˈtri:v]	vt.	 重新得到，取回；挽回，补救；检索	
disease	[diˈzi:z]	n.	 疾病	
heave	[hi:v]	n.	 举起	
live	[liv]	vi.	 活的，生动的，直播的	
colony	[ˈkɔləni]	n.	 殖民地；侨民；聚居区；（动植物的）群体	
embrace	[imˈbreis]	v.	 拥抱；包含；包围；环绕；采用；接受	
deceive	[diˈsi:v]	v.	 欺骗，蒙蔽	
coil	[kɔil]	n.	 （一）卷，（一）圈；线圈，绕组	
collar	[ˈkɔlə]	n.	 衣领；环状物	
stroll	[strəul]	n.	 漫步；散步；游荡	
symptom	[ˈsimptəm]	n.	 （疾病的）症状；（不好事情的）征兆，表征	
riddle	[ˈridl]	n.	 谜，谜语	
cannon	[ˈkænən]	n.	 大炮，火炮	
chill	[tʃil]	v.	 使寒冷	
expect	[iksˈpekt]	v.	 预期；期望，指望	
airport	[ˈɛəpɔ:t]	n.	 机场，航空站，航空港	
horsepower	[ˈhɔ:sˌpauə]	n.	 [机]马力	
cable	[ˈkeibl]	v.	 拍电报	
procession	[prəˈseʃən]	n.	 队伍，行列	
clue	[klu:]	n.	 线索，暗示	
ferry	[ˈferi]	v.	 摆渡；渡运（人，车或物等）	
conservation	[ˌkɔnsəˈveiʃən]	n.	 保存，保护，保守；守恒，不灭	
speed	[spi:d]	v.	 迅速，急行；加速，使加速	
consider	[kənˈsɪdə]	v.	 考虑，细想；体谅，顾及；认为，把…看作	
window	[ˈwindəu]	n.	 窗，窗口	
week	[wi:k]	n.	 星期，周	
polish	[ˈpɔliʃ]	n.	 擦光剂，上光蜡	
less	[les]	adj.	 更少的（地），更小的（地）	
patch	[pætʃ]	v.	 补，修补，掩饰	
applause	[əˈplɔ:z]	n.	 鼓掌；喝彩；夸奖，赞扬	
reluctant	[riˈlʌktənt]	adj.	 不愿的，勉强的	
preliminary	[priˈliminəri]	adj.	 预备的，初步的	
July	[dʒu:ˈlai]	n.	 七月	
aloud	[əˈlaud]	adv.	 出声地，大声地	
clothes	[kləuðz]	n.	 衣服（虽为复数，亦不可数）	
description	[disˈkripʃən]	n.	 描写，形容；种类	
pencil	[ˈpensəl]	vt.	 用铅笔写	
select	[siˈlekt]	adj.	 精选的，选择的	
excessive	[ikˈsesiv]	adj.	 过多的；过分的；额外	
stain	[stein]	v.	 沾污；染色	
obstruct	[əbˈstrʌkt]	n.	 阻碍物，障碍物	
bait	[beit]	vt.	 置诱饵于…；引诱；折磨	
broad	[brɔ:d]	adj.	 宽的，广阔的；广大的；宽宏的，豁达的	
colonial	[kəˈləunjəl]	n.	 殖民地居民	
speculate	[ˈspekjuleit]	vt.	 投机；思索，推测	
know	[nəʊ]	v.	 知道，了解；认识；识别	
disposal	[disˈpəuzəl]	n.	 处理，处置；布置，安排	
internal	[inˈtə:nəl]	adj.	 内部的；国内的，内政的	
bet	[bet]	n.	 打赌，赌注	
eyesight	[ˈaisait]	n.	 视力	
well	[wel]	adj.	 有名的，著名的	
general	[ˈdʒenərəl]	n.	 将军	
muscle	[ˈmʌsl]	n.	 肌肉，体力	
whichever	[hwitʃˈevə]	pron.	 无论哪个，无论哪些	
January	[ˈdʒænjuəri]	n.	 一月	
extend	[iksˈtend]	v.	 延长，延伸；扩充；给予；提供；估价	
valve	[vælv]	n.	 阀；（英）电子管，真空管；（心脏的）瓣膜	
muscular	[ˈmʌskjulə]	adj.	 肌肉的；肌肉发达的；强健的	
toxic	[ˈtɔksik]	adj.	 有毒的；中毒的	
aside	[əˈsaid]	n.	 旁白；离题的话	
cling	[kliŋ]	v.	 （to）粘住；依附；坚持	
object	[ˈɔbdʒikt]	n.	 （to）反对	
patron	[ˈpeitrən]	n.	 赞助人；资助人；老顾客，老主顾	
female	[	adj.	 女性的；雌的；柔弱的	
metric	[ˈmetrik]	adj.	 米制的，公制的	
date	[deit]	v.	 注明…的日期；约会	
assert	[əˈsə:t]	vt.	 断言，宣称；坚持；主张（权利、权威等）	
park	[pɑ:k]	v.	 停放（汽车等），寄放	
saving	[ˈseiviŋ]	n.	 挽救，救助，节约，储蓄；储蓄金，存款	
handle	[ˈhændl]	v.	 处理，对待，操纵；触，抚养	
last	[lɑ:st]	v.	 持续	
pleasant	[ˈplezənt]	vi.	 满意；喜欢	
hide	[haid]	n.	 皮革，兽皮	
retention	[riˈtenʃən]	n.	 保留，保持，保持力，记忆力	
precious	[ˈpreʃəs]	adj.	 珍贵的，贵重的	
property	[ˈprɔpəti]	n.	 财产，资产，地产，房地产，所有物；性质，特性	
read	[ri:d]	vi.	 读到，获悉	
dinner	[ˈdinə]	n.	 正餐，宴会	
salesman	[ˈseilzmən]	n.	 售货员，推销员	
ease	[i:z]	n.	 容易；舒适，悠闲	
August	[ɔ:ˈɡʌst]	n.	 8月	
ego	[ˈeɡəu]	n.	 自我，自负，自尊，利已主义；自我意识	
rib	[rib]	n.	 肋骨，肋状物	
pupil	[ˈpju:pəl]	n.	 学生，小学生；瞳孔	
arithmetic	[əˈriθmətik]	n.	 算术，四则运算	
smell	[smel]	v.	 嗅，闻到；散发（…的）气味	
deserve	[diˈzə:v]	v.	 应受，值得	
volume	[ˈvɔlju:m]	n.	 容积，体积；卷，册；音量	
stretch	[stretʃ]	n.	 拉长；伸展；一段时间/路程	
theme	[θi:m]	n.	 题目，主题；主旋律，基调	
command	[kəˈmɑ:nd]	n.	 命令，指挥；掌握，运用能力	
defeat	[diˈfi:t]	v.	 击败，战胜；使失败	
employer	[ɪmˈplɔɪə(r)]	n.	 雇主	
wholly	[ˈhəuli]	adv.	 完全地，全部，一概	
carbohydrate	[ˌkɑ:bəuˈhaidreit]	n.	）淀粉质或糖类	
spectacle	[ˈspektəkl]	n.	 场面，景象；奇观；眼镜	
drawing	[ˈdrɔ:ɪŋ]	n.	 绘图，图样	
possible	[ˈpɔsəbl]	adj.	 可能的，做得到的；合理的；可允许的	
courtyard	[ˈkɔ:tjɑ:d]	n.	 院子，庭院，天井	
honey	[ˈhʌni]	n.	 蜜，蜂蜜	
worthwhile	[ˌwə:θˈwail]	adj.	 值得（做）的	
certify	[ˈsə:tifai]	vt.	 证明，证实；发证书（或执照）给	
domestic	[dəˈmestik]	adj.	 家里的；本国的；驯养的	
have	[hæv]	v.	 有，具有；体会，经受；从事；使；吃，喝	
capacity	[kəˈpæsiti]	n.	 容量，容积；能量，能力；接受力	
loop	[lu:p]	n.	 圈，环	
novelty	[ˈnɔvəlti]	n.	 新奇，新颖，新奇的事物	
prescription	[prisˈkripʃən]	n.	 药方，处方	
postage	[ˈpəustidʒ]	n.	 邮费，邮资	
route	[ru:t]	n.	 路线，路程	
inn	[in]	n.	 小旅馆，客栈	
acquaint	[əˈkweint]	vt.	 （with）使认识，使了解，使熟悉	
comparable	[ˈkɔmpərəbl]	adj.	 （with，to）可比较的，比得上的	
universal	[ˌju:niˈvə:səl]	adj.	 普遍的，全体的，通用的；宇宙的，世界的	
rainbow	[ˈreinbəu]	n.	 虹	
proceeding	[prəˈsi:diŋ]	n.	 行动，进行；会议录，学报	
recent	[ˈri:snt]	adj.	 新近的，近来的	
veil	[veil]	v.	 用面纱掩盖，掩饰	
extinguish	[iksˈtiŋɡwiʃ]	v.	 熄灭；消灭；结束；压制；使黯然失色；偿清	
compulsory	[kəmˈpʌlsəri]	adj.	 必须做的，强制性的，（课程）必修的	
contemporary	[kənˈtempərəri]	adj.	 现代的，当代的；同时代的	
deteriorate	[diˈtiəriəreit]	v.	 （使）恶化，（使）变坏	
unity	[ˈju:niti]	n.	 团结；统一，一致，整体	
zeal	[zi:l]	n.	 热心，热忱，热情	
sound	[saund]	adj.	 健全的，完好的；正当的	
fit	[fit]	v.	 合适，试穿，安装	
clarity	[ˈklæriti]	n.	 清晰，明晰	
firm	[fə:m]	n.	 公司，商号	
special	[ˈspeʃəl]	adj.	 特殊的，专门的；附加的，额外的	
inject	[inˈdʒekt]	vt.	 注射（药液等）；注入	
exceed	[ikˈsi:d]	v.	 超过，胜过；越出	
industrial	[inˈdʌstriəl]	adj.	 工业的，产业的	
battle	[ˈbætl]	v.	 战斗，斗争，搏斗	
kindergarten	[ˈkindəˌɡɑ:tən]	n.	 幼儿园	
expenditure	[ɪkˈspendətʃə]	n.	 花费；（时间，金钱等的）支出，消耗	
frown	[fraun]	v.	 皱眉，不同意	
crop	[krɔp]	n.	 作物，庄稼；（谷类等的）一熟收成；一批，大量	
insert	[inˈsə:t]	n.	 插入物	
pyramid	[ˈpirəmid]	n.	 金字塔	
marital	[ˈmæritl]	adj.	 婚姻的，夫妻之间的	
triple	[ˈtripl]	v.	 使成三倍	
hostage	[ˈhɔstidʒ]	n.	 人质	
refund	[ˈriːfʌnd]	v.	 退还，偿还，偿付	
pessimistic	[ˌpesɪˈmɪstɪk]	adj.	 悲观（主义）的	
audit	[ˈɔ:dit]	v.	 审计；查帐；核对；旁听	
remove	[riˈmu:v]	v.	 移动，脱掉，调动，免职	
discount	[ˈdiskaunt]	vt.	 打折扣；不重视	
register	[ˈredʒistə]	v.	 （仪表等）指示，（邮件）挂号；注册	
stall	[stɔ:l]	v.	 （使）停转，（使）停止	
inferior	[inˈfiəriə]	n.	 下级，晚辈	
shadow	[ˈʃædəu]	n.	 阴影，影子，荫；暗处，阴暗	
diameter	[daiˈæmitə]	n.	 直径	
heart	[hɑ:t]	n.	 心（脏）；内心，感情；热忱；中心，要点	
directly	[diˈrektli]	adv.	 直接地，径直地；马上，立即	
nearby	[ˈniəbai]	prep.	 在…附近	
inventory	[ˈɪnvəntri]	n.	 详细目录；清单；储备；存货	
surpass	[səˈpɑ:s]	vt.	 超过，胜过	
guest	[ɡest]	n.	 客人，宾客，旅客	
faith	[feiθ]	n.	 信任，信用；信仰，信条	
modern	[ˈmɔdən]	adj.	 现代的，近代的，新式的	
indeed	[inˈdi:d]	adv.	 确实，实在	
abundance	[əˈbʌndəns]	n.	 丰富，充裕，大量	
explosive	[iksˈpləusiv]	n.	 爆炸物，炸药	
convenience	[kənˈvi:njəns]	n.	）便利设备	
dust	[dʌst]	v.	 拂，掸	
indulge	[inˈdʌldʒ]	v.	 纵容；迁就；娇惯；使沉迷	
central	[ˈsentrəl]	adj.	 中心的，中央的，中枢的；主要的	
reproduce	[ˌri:prəˈdju:s]	v.	 生殖；翻版；繁殖；复制，仿造	
abolish	[əˈbɔliʃ]	vt.	 废除（法律、习惯等）；取消	
stable	[ˈsteibl]	n.	 马厩，马棚	
independence	[ˌɪndiˈpendəns]	n.	 独立，自主	
send	[send]	v.	 （sent，sent）打发；派遣；送；寄出	
grown	[grəʊn]	n.	 成年人	
crucial	[ˈkru:ʃəl]	adj.	 至关重要的，决定性的	
hydrogen	[ˈhaidrədʒən]	n.	 氢	
journey	[ˈdʒə:ni]	v.	 旅行	
recall	[riˈkɔ:l]	v.	 回忆，回想；撤消，收回	
compartment	[kəmˈpɑ:tmənt]	n.	 卧车包房，（客车车厢内的）隔间；分隔的空间	
slight	[slait]	adj.	 轻微的，微小的；纤细的，瘦弱的	
house	[haus]	v.	 给…房子住	
snowstorm	[ˈsnəʊˌstɔ:m]	n.	 暴风雪	
prominent	[ˈprɔminənt]	adj.	 突起的，凸出的；突出的，杰出的	
mock	[mɔk]	n.	）模拟考试	
professor	[prəˈfesə]	n.	 教授	
die	[dai]	vi.	 死，死亡；（草木）枯萎，凋谢；渴望	
time	[taim]	n.	 时间；次，回；时代；倍，乘	
petition	[piˈtiʃən]	v.	 （向…）请愿，正式请求	
soccer	[ˈsɔkə]	n.	 足球	
booth	[buːð]	n.	 电话亭，货摊，雅座	
until	[ənˈtil]	conj.	 直到…为止，在…以前；直到…	
ally	[ˈælaɪ]	vt.	 使结盟；与…有关联	
Easter	[ˈi:stə]	n.	 复活节	
operate	[ˈɔpəreit]	v.	 操作，运转，开动，起作用，动手术	
anonymous	[əˈnɔnəməs]	adj.	 匿名的，无名的；不记名的	
inhibit	[inˈhibit]	vt.	 抑制，约束	
revolutionary	[ˌrevəˈlu:ʃənəri]	n.	 革命者	
deduct	[diˈdʌkt]	vt.	 扣除；演绎（推理）	
ancestor	[ˈænsistə]	n.	 祖宗，祖先；原型，先驱	
outfit	[ˈautfit]	v.	 配备，（得到）装备	
thing	[θiŋ]	n.	 东西；事情；所有物；局面	
poisonous	[ˈpɔizənəs]	adj.	 有毒的，恶意的，恶毒的，道德败坏的	
visual	[ˈviʒuəl]	adj.	 看的，看得见的；视觉的	
black	[blæk]	n.	 黑（色）；黑暗；黑人	
lump	[lʌmp]	v.	 （使）成团，（使）成块	
aspect	[ˈæspekt]	n.	 样子，外表，面貌，（问题等的）方面	
violin	[ˌvaiəˈlin]	n.	 小提琴	
scope	[skəup]	n.	 （活动）范围；机会，余地	
quest	[kwest]	n.	 探寻，探求；寻求，追求	
sky	[skai]	n.	 天空	
succeed	[səkˈsi:d]	vt.	 接替；继…之后	
predominant	[priˈdɔminənt]	adj.	 （over）占优势的；主要的，突出的	
pollute	[pəˈlu:t]	v.	 弄脏，污染	
blur	[blə:]	vt.	 使模糊；玷污	
tea	[ti:]	n.	 茶（叶）；午后茶点	
guideline	[ˈɡaidlain]	n.	 指导方针，指导原则，准则，标准	
agriculture	[ˈæɡrikʌltʃə]	n.	 农业，农艺，农耕	
breed	[bri:d]	n.	 品种	
star	[stɑ:]	v.	 用星号标出；扮演主角	
impact	[ˈimpækt]	v.	 影响；挤入，压紧	
coffee	[ˈkɔfi]	n.	 咖啡（色）	
abide	[əˈbaid]	vi.	 （by）遵守；坚持	
sandwich	[ˈsænwidʒ]	v.	 夹入，挤进	
acute	[əˈkju:t]	adj.	 剧烈的；敏锐的；成锐角的；尖的	
willing	[ˈwiliŋ]	adj.	 愿意的，乐意的，心甘情愿的	
chairman	[ˈtʃɛəmən]	n.	 主席，议长，会长，董事长	
bond	[bɔnd]	n.	 结合（物），粘结（剂），联结；公债，债券，契约	
fare	[fɛə]	v.	 过活；进展；经营	
root	[ru:t]	v.	 （使）生根，（使）扎根	
full	[ful]	adv.	 完全，充分	
impossible	[imˈpɔsəbl]	adj.	 不可能的；难以忍受的，很难对付的	
beef	[bi:f]	n.	 牛肉；体力；怨言，牢骚	
passport	[ˈpɑ:spɔ:t]	n.	 护照，达到某种目的的手段	
gentleman	[ˈdʒentlmən]	n.	 绅士，先生	
exception	[ikˈsepʃən]	n.	 例外，除外；反对；异议	
species	[ˈspi:ʃi:z]	n.	 （物）种，种类	
canoe	[kəˈnu:]	n.	 独木舟，小游艇	
thrive	[θraiv]	v.	 兴旺，繁荣	
navigation	[ˌnæviˈɡeiʃən]	n.	 航海，航空；导航，领航	
mutton	[ˈmʌtn]	n.	 羊肉	
credential	[kriˈdenʃəl]	n.	 凭证；国书，证明书	
message	[ˈmesidʒ]	n.	 消息，信息，通讯，启示，教训，广告词，预言	
pool	[pu:l]	v.	 合伙经营，联营	
comparison	[kəmˈpærisən]	n.	 比较，对比，比喻，比拟	
duplicate	[ˈdju:plikit]	n.	 复制的，二重的	
wish	[wiʃ]	n.	 愿望，希望	
mercy	[ˈmə:si]	n.	 仁慈，怜悯，宽恕	
constitution	[ˌkɔnstiˈtju:ʃən]	n.	 构成，构造，组成（方式），成分；体格；宪法	
duck	[dʌk]	v.	 迅速俯身；快速低头；躲避	
browse	[brauz]	vi.	 随意翻阅，浏览；（牛、羊等）吃草	
repertoire	[ˈrepətwɑ:]	n.	 节目，全部剧目，保留剧目，全部技能	
total	[ˈtəutəl]	v.	 合计，总数达	
relation	[riˈleiʃən]	n.	 关系，联系；亲属，亲戚	
dwelling	[ˈdwelɪŋ]	n.	 住宅，寓所	
denote	[diˈnəut]	vt.	 表示，意味着	
implement	[ˈimplimənt]	v.	 贯彻，实现	
tire	[ˈtaiə]	n.	 （=tyre）轮胎，车胎	
throughout	[	adv.	 到处，自始至终，彻底	
test	[test]	n.	 试验；检验；测验	
clutch	[klʌtʃ]	n.	 离合器	
comprehend	[ˌkɔmpriˈhend]	vt.	 理解，领会；包含，包括	
bleak	[bli:k]	adj.	 荒凉的；冷酷的；没有希望的	
guilty	[ˈɡilti]	adj.	 （of）有罪的，内疚的	
gramme	[ɡræm]	n.	 克	
canvas	[ˈkænvəs]	n.	 帆布；帆布画布，（帆布）油画	
creative	[kriˈeitiv]	adj.	 有创造力的，创造性的	
ratio	[ˈreiʃiəu]	n.	 比，比率	
shoot	[ʃu:t]	n.	 嫩枝，苗，射击	
institution	[ˌɪnstiˈtju:ʃən]	n.	 公共机构；协会；学校；研究所；制度；惯例	
formulate	[ˈfɔ:mjuleit]	v.	 用公式表示；规划；设计；系统地阐述	
inevitable	[inˈevitəbl]	adj.	 不可避免的，必然发生的	
big	[biɡ]	adj.	 大的；重要的；宽宏大量的；大受欢迎的	
shop	[ʃɔp]	v.	 买东西	
graph	[ɡrɑ:f]	n.	 图表，曲线图	
white	[hwait]	n.	 白色；白种人	
soft	[sɔft]	adj.	 软的；温柔的；细嫩的；不含酒精的	
composite	[ˈkɔmpəzit]	n.	 合成物，复合材料	
agreeable	[əˈɡri:əbl]	adj.	 符合的；一致的；欣然同意的	
exercise	[ˈeksə]	v.	 训练，锻练；行使	
column	[ˈkɔləm]	n.	 圆柱，柱状物；列；（报刊中的）专栏	
revive	[riˈvaiv]	v.	 恢复；（使）复苏	
expensive	[iksˈpensiv]	adj.	 花费的，昂贵的	
apply	[əˈplai]	vt.	 应用；实施；涂；敷（药）	
unemployment	[ˌʌnimˈplɔimənt]	n.	 失业，失业人数	
giggle	[ˈɡiɡl]	v.	 咯咯地笑着说，咯咯地笑，傻笑	
parent	[ˈpɛərənt]	n.	 双亲；父母	
within	[wiˈðin]	adv.	 在内	
tiny	[ˈtaini]	adj.	 极小的，微小的	
film	[film]	vt.	 把…拍成电影	
foreign	[ˈfɔrin]	adj.	 外国的，（to）无关的；外来的；异质的	
preside	[priˈzaid]	v.	 （at，over）主持	
excursion	[iksˈkə:ʃən]	n.	 短途旅行，游览；离题；[物理]偏移，漂移	
furnish	[ˈfə:niʃ]	v.	 供应，提供；装备，布置	
golden	[ˈɡəuldən]	adj.	 金黄色的；贵重的，极好的	
handicap	[ˈhændikæp]	n.	 （身体或智力方面的）缺陷；不利条件	
wander	[ˈwɔndə]	v.	 漫步，徘徊；迷路；离题	
survival	[səˈvaivəl]	n.	 幸存，生存；幸存者，残存物	
slam	[slæm]	n.	 猛然关闭的声音	
individual	[ˌɪndiˈvidjuəl]	n.	 个人，个体	
chase	[tʃeis]	v.	 追逐，追求	
velvet	[ˈvelvit]	adj.	 丝绒制的，柔软的	
several	[ˈsevrəl]	adj.	 几个，若干，数个；各个的，各自的	
intact	[inˈtækt]	adj.	 完整无缺的；未受损伤的	
embody	[imˈbɔdi]	vt.	 具体表达，使具体化；包含，收录	
wrench	[rentʃ]	n.	 扳手；痛苦，难受	
sanction	[ˈsæŋkʃən]	n.	 处罚，制裁；批准，认可	
slipper	[ˈslipə]	n.	 便鞋，拖鞋	
besides	[biˈsaidz]	prep.	 于…之外；除…以外	
spur	[spə:]	v.	 刺激，激励	
tow	[təu]	n.	 拖，牵引	
corresponding	[ˌkɔrisˈpɔndiŋ]	adj.	 符合的，相应的，对应的	
golf	[ɡɔlf]	n.	 高尔夫球	
mature	[məˈtjuə]	v.	 （使）成熟	
such	[sʌtʃ]	pron.	 这样的人/事物	
provoke	[prəˈvəuk]	v.	 挑动；激发；招惹	
art	[ɑ:t]	n.	 艺术，美术；技术，技艺；文科	
cherish	[ˈtʃeriʃ]	vt.	 抱有，怀有（希望等）；爱护，抚育；珍爱	
simultaneous	[ˌsiməlˈteinjəs]	adj.	 同时的，同时存在的	
criminal	[ˈkriminəl]	adj.	 犯罪的，刑事的	
exact	[iɡˈzækt]	adj.	 确切的，正确的，精确的	
fable	[ˈfeibl]	n.	 寓言	
polar	[ˈpəulə]	n.	 极线，极面	
unite	[ju:ˈnait]	vt.	 使联合	
mingle	[ˈmiŋɡl]	v.	 （使）混合	
trick	[trik]	vt.	 欺骗，哄骗	
generator	[ˈdʒenəreitə]	n.	 发电机，发生器	
discovery	[disˈkʌvəri]	n.	 发现；被发现的事物	
controversy	[ˈkɔntrəvə:si]	n.	 争论，辩论，争吵	
apparatus	[ˌæpəˈreitəs]	n.	 器械，器具，仪器；机构，组织	
ultraviolet	[ˌʌltrəˈvaiəlit]	adj.	 紫外线（的）	
drill	[dril]	n.	 操练；练习；钻孔（机）	
watt	[wɔt]	n.	 瓦，瓦特	
further	[ˈfə:ðə]	v.	 促进，增进	
elaborate	[iˈlæbəreit]	v.	 精心制作（的）；详细阐述（的）	
dollar	[ˈdɔlə]	n.	 （美国，加拿大等国货币单位）美元，加元	
temptation	[tempˈteiʃən]	n.	 引诱，诱惑；诱惑物	
slaughter	[ˈslɔ:tə]	vt.	 屠杀，宰杀	
winter	[ˈwintə]	n.	 冬季，冬天	
look	[luk]	n.	 注视；外表，脸色	
pill	[pil]	n.	 药丸	
retail	[ˈri:teil]	n.	 零售	
honorable	[ˈɔnərəbl]	adj.	 （honourable）可敬的；荣誉的，光荣的	
after	[ˈɑ:ftə]	adv.	 以后，后来	
tradition	[trəˈdiʃən]	n.	 传统；惯例；传说	
presence	[ˈprezəns]	n.	 出席，到场，存在，在	
ideology	[ˌaidiˈɔlədʒi]	n.	 意识形态，（政治或社会的）思想意识	
market	[ˈmɑ:kit]	v.	 销售	
sue	[sju:]	v.	 控告，对…提出诉讼，起诉	
people	[ˈpi:pl]	n.	 人们，人；[the-]人民；一国人民，民族	
probable	[ˈprɔbəbl]	adj.	 很可能的，大概的；有希望的，可能的	
seed	[si:d]	v.	 播种；结实，结籽	
deposit	[diˈpɔzit]	n.	 存款；沉积物	
accent	[ˈæksənt]	n.	 重读；标注重音	
neutral	[ˈnju:trəl]	adj.	 中立的；中性的，中和的	
scheme	[ski:m]	v.	 计划，策划；阴谋	
exist	[iɡˈzist]	v.	 存在；生存；生活	
numerical	[nju:ˈmerikəl]	adj.	 数字的，用数字表示的，数值的	
hinder	[ˈhində]	adj.	 后面的	
than	[ðən]	conj.	 （用于形容词，副词的比较级之后）比	
fifteen	[fɪfˈti:n]	pron.	 十五（个，只…）	
caress	[kəˈres]	vt.	 爱抚，抚摸	
cousin	[ˈkʌzn]	n.	 堂（或表）兄弟，堂（或表）姐妹	
plausible	[ˈplɔ:zəbl]	adj.	 似是而非的，似乎合理的，似乎可信的	
board	[bɔ:d]	v.	 上船（车，飞机）	
destroy	[disˈtrɔi]	v.	 破坏，摧毁，消灭	
harbor	[ˈhɑ:bə]	v.	 隐匿，窝藏	
forge	[fɔ:dʒ]	n.	 锻工车间；锻炉	
partly	[ˈpɑ:tli]	adv.	 部分地，不完全地，在一定程度上	
chapter	[ˈtʃæptə]	n.	 章；回，篇	
personality	[ˌpə:səˈnæliti]	n.	 人格，个性	
programme	[ˈprəu-ɡræm]	v.	 计划；训练；编程序	
party	[ˈpɑ:ti]	v.	 举行（参加）社交聚会	
cab	[kæb]	vi.	 乘出租车	
relief	[riˈli:f]	n.	 （痛苦等）减轻，解除；援救，救济	
revolution	[ˌrevəˈlu:ʃən]	n.	 革命；旋转，转数	
rest	[rest]	v.	 休息；睡；放，靠，搁	
technical	[ˈteknikəl]	adj.	 技术（性）的，工艺的；专门性的，专业性的	
quite	[kwait]	adv.	 十分，完全；相当，颇；的确，真正	
meat	[mi:t]	n.	 （食用）肉类	
hard	[hɑrd]	adj.	 坚硬的；结实的；困难的；难忍的；严厉的	
socialism	[ˈsəuʃəlizəm]	n.	 社会主义	
heroic	[hiˈrəuik]	adj.	 英雄的，英勇的，崇高的	
rage	[reɪdʒ]	n.	 愤怒	
claw	[klɔ:]	n.	 爪，脚爪	
cop	[kɔp]	n.	 警察（俚语）	
suppress	[səˈpres]	v.	 镇压，压制；抑制，忍住；查禁	
propose	[prəˈpəuz]	v.	 提议，建议；提名，推荐；求婚	
commodity	[kəˈmɔditi]	n.	 日用品；商品；农/矿产品；有用之物	
prey	[prei]	v.	 捕食，掠夺，折磨	
tip	[tip]	v.	 轻击；倾斜；给小费	
trait	[treit]	n.	 特征，特点，特性	
knowledge	[ˈnɔlidʒ]	n.	 知识，学识；知道，了解	
continue	[kənˈtinju]	v.	 继续，连续，延伸	
reproach	[riˈprəutʃ]	v.	 责备，指责	
place	[pleis]	v.	 安排；放置；投（资）	
measure	[ˈmeʒə]	n.	 尺寸，量度器，措施，办法	
tongue	[tʌŋ]	n.	 舌；语言	
forthcoming	[fɔ:θˈkʌmiŋ]	n.	 来临	
raid	[reid]	n.	 袭击，搜查	
imitation	[ˌɪmiˈteiʃən]	n.	 模仿，仿效；仿制；仿造品	
situated	[ˈsitjueitid]	v.	 坐落在…（的）	
intend	[inˈtend]	vt.	 想要，打算，企图	
planet	[ˈplænit]	n.	 行星	
automatic	[ˌɔ:təˈmætik]	n.	 自动机械	
rub	[rʌb]	v.	 擦，摩擦	
texture	[ˈtekstʃə]	n.	 （织物）质地；（材料）构造；结构；肌理	
container	[kənˈteinə]	n.	 容器；集装箱	
breakfast	[ˈbrekfəst]	v.	 （给某人）吃早餐	
conductor	[kənˈdʌktə]	n.	 管理者；（汽车）售票员；领队，指挥；导体	
rebel	[	vi.	 叛逆者，起义者	
puff	[pʌf]	v.	 喘息，鼓吹；喷出	
seam	[si:m]	n.	 缝，接缝	
destiny	[ˈdestini]	n.	 命运；天数，天命	
hesitate	[ˈheziteit]	v.	 犹豫，踌躇；含糊，支吾	
pressure	[ˈpreʃə]	n.	 压，压力，压迫，强制，紧迫，困苦，困难	
accelerate	[ækˈseləreit]	v.	 （使）加速，（使）增速，促进	
belly	[ˈbeli]	n.	 肚子，腹部；（像肚子一样）鼓起的部分，膛	
size	[saiz]	n.	 大小，尺寸，规模；尺码	
superfluous	[sju:ˈpə:fluəs]	adj.	 多余的，过剩的	
coin	[kɔin]	v.	 铸造（硬币），创造（新词）	
attain	[əˈtein]	vi.	 达到	
penetrate	[ˈpenitreit]	v.	 穿过，渗入，看穿	
vague	[veiɡ]	adj.	 不明确的，含糊的，暧昧的	
porter	[ˈpɔ:tə]	n.	 守门人，门房，行李搬运工，服务员	
appal	[əˈpɔ:l]	v.	 使惊骇，使恐怖	
component	[kəmˈpəunənt]	adj.	 组成的，合成的	
stake	[steik]	n.	 桩，标桩；赌注，利害关系	
sometime	[ˈsʌmtaim]	adj.	 以前的	
regardless	[riˈɡɑ:dlis]	adj.	 不管…的，不顾…的，不注意的	
shower	[ˈʃauə]	v.	 下阵雨，倾注	
wash	[wɔʃ]	vi.	 洗澡	
inform	[inˈfɔ:m]	v.	 （of，about）通知，告诉，报告；告发，告密	
disregard	[ˌdisriˈɡɑ:d]	n.	 忽视；漠视	
unless	[ʌnˈles]	prep.	 除…外	
wealthy	[ˈwelθi]	n.	 富人，有钱人	
mother	[ˈmʌðə]	n.	 母亲	
December	[diˈsembə]	n.	 十二月	
saddle	[ˈsædl]	n.	 鞍，马鞍，鞍状物	
rapid	[ˈræpid]	n.	 急流，湍滩	
precise	[priˈsais]	adj.	 精确的，准确的	
during	[ˈdjuəriŋ]	prep.	 在…期间	
defy	[diˈfai]	v.	 （公然）违抗，反抗；蔑视	
rouse	[rauz]	vt.	 唤醒，唤起；激励；激起	
possess	[pəˈzes]	v.	 占有，拥有	
productivity	[ˌprɔdʌkˈtiviti]	n.	 生产率	
sponge	[spʌndʒ]	n.	 海绵	
stationery	[ˈsteiʃənəri]	n.	 文具	
inlet	[ˈinlet]	n.	 水湾，小湾；进口，入口	
anniversary	[ˌæniˈvə:səri]	n.	 周年，周年纪念日	
pursuit	[pəˈsju:t]	n.	 追赶，追求；职业，工作	
mental	[ˈmentl]	adj.	 精神的，思想的，心理的，智力的，脑力的	
digital	[ˈdidʒitəl]	n.	 数字	
entity	[ˈentiti]	n.	 实体；存在（物）；组织，机构；本质	
sham	[ʃæm]	n.	 假冒（的），虚伪（的）	
candle	[ˈkændl]	n.	 蜡烛	
plot	[plɔt]	v.	 标绘，绘制；密谋，策划	
quality	[ˈkwɔliti]	n.	 质量，品质，特性	
dress	[dres]	v.	 穿衣，打扮	
appraisal	[əˈpreizəl]	n.	 对…作出的评价；评价，鉴定，评估	
underground	[ˈʌndəɡraund]	adv.	 在地下	
excite	[ikˈsait]	v.	 刺激，使激动；激发，激励	
sake	[seik]	n.	 缘故，理由	
arch	[ɑ:tʃ]	v.	 拱起，（使）变成弓形	
thermal	[ˈθə:məl]	adj.	 热的，热力的；（小规模的）上升气流	
cheer	[tʃiə]	n.	 喝彩，欢呼	
achieve	[əˈtʃi:v]	vi.	 达到预期目的	
secondary	[ˈsekəndəri]	adj.	 次要的，二级的；中级的，第二的	
tailor	[ˈteilə]	v.	 缝制，剪裁	
international	[ˌɪntəˈnæʃənəl]	adj.	 国际的，国际上的	
small	[smɔ:l]	adj.	 小的；年幼的；不重要的；小规模（经营）的	
mathematical	[ˌmæθiˈmætikəl]	adj.	 数学的；数学上的	
pasture	[ˈpɑ:stʃə]	n.	 牧草地，牧场	
hate	[heit]	n.	 恨，憎恶	
estate	[isˈteit]	n.	 房地产；不动产；所有权；地位；生活状况	
blouse	[blauz]	n.	 女衬衣，短上衣，宽阔的罩衫	
perceive	[pəˈsi:v]	v.	 察觉，感知；理解，领悟	
withdraw	[wiðˈdrɔ:]	v.	 收回，撤消；缩回，退出；提取（钱）	
minus	[ˈmainəs]	n.	 负号，减号	
perfume	[ˈpə:fju:m]	v.	 使发香，洒香水于	
earnest	[ˈə:nist]	n.	 热心；真挚；定金；认真	
ignorant	[ˈiɡnərənt]	adj.	 无知的，愚昧的；不知道的	
presume	[priˈzju:m]	v.	 假定，假设，认为，揣测，滥用，擅自行动	
adjoin	[əˈdʒɔin]	v.	 临近，靠近；贴近，毗连	
overcome	[ˌəuvəˈkʌm]	v.	 战胜，克服	
cancer	[ˈkænsə]	n.	 癌	
variety	[vəˈraiəti]	n.	 多种多样；种类，品种	
ascend	[əˈsend]	vt.	 攀登，登上	
remark	[riˈmɑ:k]	v.	 （on）评论；注意到	
public	[ˈpʌblik]	n.	 公众，民众	
pea	[piː]	n.	 豌豆	
bridge	[bridʒ]	vt.	 架桥；渡过	
intelligible	[inˈtelidʒəbl]	adj.	 可理解的；明白易懂的	
maybe	[ˈmeibi:]	adv.	 可能；大概；也许	
pit	[pit]	n.	 坑，陷阱；煤矿，矿井	
cross	[krɔs]	v.	 穿过	
choke	[tʃəuk]	v.	 窒息，噎住；闷塞，堵塞，阻塞	
fish	[fiʃ]	v.	 捕鱼；钓鱼	
dramatic	[drəˈmætik]	adj.	 戏剧的，戏剧性的；剧烈的；激动人心的	
dry	[drai]	vt.	 使干燥，晒干	
violet	[ˈvaiəlit]	adj.	 紫色的	
reconcile	[ˈrekənsail]	v.	 使和好，使调和；（to，with）使一致	
drip	[drip]	n.	 滴，水滴，点滴	
guilt	[gɪlt]	n.	 罪过，内疚	
image	[ˈimidʒ]	n.	 形象，声誉；印象；像；形象的描述，比喻	
manufacture	[ˌmænjuˈfæktʃə]	n.	 制造，制造业；产品	
withstand	[wiðˈstænd]	vt.	 抵抗，经受住	
finite	[ˈfainait]	adj.	 有限的；[数]有穷的，限定的	
classmate	[ˈklɑ:smeit]	n.	 同班同学	
commence	[kəˈmens]	vi.	 获得学位	
nightmare	[ˈnaitmɛə]	n.	 恶梦；可怕的事物，无法摆脱的恐惧	
thunder	[ˈθʌndə]	v.	 打雷；大声说，吼叫	
amaze	[əˈmeiz]	vi.	 表现出惊奇	
magistrate	[ˈmædʒistrit]	n.	 地方行政官，地方法官，治安官	
liberate	[ˈlibəreit]	vt.	 解放，释放	
siren	[ˈsaiərin]	n.	 警报声，警报器	
manual	[ˈmænjuəl]	n.	 手册，指南	
governor	[ˈɡʌvənə]	n.	 统治者，管理者，总督，州（省）长	
radius	[ˈreidjəs]	n.	 半径，半径范围，有效航程，范围，界限	
whirl	[hwə:l]	n.	 旋转；-连串快速的活动	
nice	[nais]	adj.	 美好的，令人愉快的；友好的，亲切的	
entitle	[inˈtaitl]	v.	 给以权利（或资格）；给…称号（题名）；授权	
alliance	[əˈlaiəns]	n.	 同盟，同盟国；结盟，联姻	
brush	[brʌʃ]	v.	 刷，擦，掸，拂；掠过	
behave	[biˈheiv]	v.	 举止，举动，表现；运转，起作用	
visitor	[ˈvizitə]	n.	 访问者，客人，来宾，参观者	
silence	[ˈsailəns]	v.	 使沉默，使安静	
rust	[rʌst]	v.	 （使）生锈	
smuggle	[ˈsmʌɡl]	v.	 走私；偷运	
gift	[ɡift]	n.	 礼品，赠品；天赋，才能	
lever	[ˈli:və]	n.	 杆，杠杆，手段，途径，工具	
mould	[məuld]	v.	 浇铸，造型，塑造	
suburb	[ˈsʌbə:b]	n.	 市郊，郊区	
legend	[ˈledʒənd]	n.	 传说，传奇	
pendulum	[ˈpendjuləm]	n.	 摆，钟摆	
wife	[waif]	n.	 妻子，夫人，太太	
objective	[əbˈdʒektiv]	adj.	 客观的，真实的	
difference	[ˈdifərəns]	n.	 差别，差异，分歧	
database	[ˈdeitəbeis]	n.	 （databank）数据库	
speak	[spi:k]	v.	 说话；演说，发言；（in）说某种语言	
handy	[ˈhændi]	adj.	 手边的，近便的；方便的	
pace	[peis]	v.	 踱步，用步测	
bosom	[ˈbuzəm]	adj.	 亲密的	
grammar	[ˈɡræmə]	n.	 语法，语法书	
boast	[bəust]	n.	 自夸，大话	
overflow	[ˌəuvəˈfləu]	v.	 （使）外溢，（使）溢出；溢出，流出，漫出	
label	[ˈleibəl]	v.	 把…称为；用标签于；用标签标明	
cup	[kʌp]	n.	 杯子；奖杯，优胜杯；一杯的量	
detain	[diˈtein]	v.	 耽搁；扣押，拘留	
stereo	[ˈstiəriəu]	adj.	 立体声（的）	
decline	[diˈklain]	n.	 下降；斜面，倾斜，衰落	
create	[kriˈeit]	v.	 创造，创作；引起，造成，建立	
skirt	[skə:t]	n.	 裙子；边缘，郊区	
chaos	[ˈkeiɔs]	n.	 混乱，紊乱	
fair	[fɛə]	n.	 集市，交易会	
facility	[fəˈsiliti]	n.	 灵巧，熟练；设备，设施，便利条件	
terrific	[təˈrifik]	adj.	 极好的，非常的，极度的	
refreshment	[riˈfreʃmənt]	n.	 点心，饮料；精力恢复，爽快	
noise	[nɔiz]	n.	 喧闹声，噪声，吵嚷声	
pedal	[ˈpedl]	v.	 踩踏板，骑自行车	
ending	[ˈendiŋ]	n.	 结尾，结局	
alleviate	[əˈli:vieit]	v.	 减轻，缓和，缓解（痛苦等）	
department	[diˈpɑ:tmənt]	n.	 部，局，处，科，部门；系，学部	
stream	[stri:m]	v.	 流出，涌	
acquire	[əˈkwaiə]	v.	 获得；学到（知识等）；养成（习惯）	
advantage	[ədˈvɑ:ntidʒ]	n.	 优点，长处，有利条件；利益，好处	
deck	[dek]	n.	 甲板	
intense	[inˈtens]	adj.	 强烈的；剧烈的；极度的	
associate	[əˈsəuʃieit]	adj.	 联合的	
likewise	[ˈlaikwaiz]	adv.	 同样地，照样地；又，也，而且	
omit	[əuˈmit]	v.	 省略，删去；遗漏，忽略	
imaginative	[iˈmædʒinətiv]	adj.	 富有想象力的，爱想象的	
blood	[blʌd]	n.	 血液，血；血统，血亲；血气	
driver	[ˈdraivə]	n.	 驾驶员	
eager	[ˈi:ɡə]	adj.	 （for）渴望的，热切的	
venture	[ˈventʃə]	n.	 冒险事业，拼，闯	
round	[raund]	n.	 （一）回合	
shape	[ʃeip]	v.	 成型，塑造	
shark	[ʃɑ:k]	n.	 鲨鱼	
past	[pɑːst]	prep.	 （经）过	
multitude	[ˈmʌltitju:d]	n.	 众多，大量	
alone	[əˈləun]	adv.	 单独地，独自地；仅仅	
slim	[slim]	v.	 减轻体重，变苗条	
deer	[diə]	n.	 鹿	
crude	[kru:d]	adj.	 天然的，未加工的；未熟的；粗鲁的，粗野的	
magnitude	[ˈmæɡnitju:d]	n.	 大小，数量；巨大，广大	
assumption	[əˈsʌmpʃən]	n.	 假定，设想；采取；承担；推测；假装	
mug	[mʌɡ]	n.	 （有柄的）大茶杯	
deceit	[diˈsi:t]	n.	 欺骗，欺骗行为	
weak	[wi:k]	adj.	 虚弱的，软弱的；不够标准的；淡薄的	
infant	[ˈɪnfənt]	n.	 婴儿，幼儿	
indignation	[ˌɪndiɡˈneiʃən]	n.	 愤怒，愤慨	
below	[biˈləu]	adv.	 在下面，向下	
bag	[bæɡ]	v.	 把…装入袋中；捕获；占有	
undo	[ˌʌnˈdu]	v.	 松开，解开	
perpetual	[pəˈpetʃuəl]	adj.	 永久的，永恒的，长期的	
badminton	[ˈbædmintən]	n.	 羽毛球	
justice	[ˈdʒʌstis]	n.	 公正，公平；审判，司法	
striking	[ˈstraikiŋ]	adj.	 显著的；惹人注目的，容貌出众的	
expose	[ikˈspəuz]	v.	 （to）使暴露；使曝光	
wheat	[hwi:t]	n.	 小麦	
role	[rəul]	n.	 角色，作用，任务，职责	
weed	[wi:d]	v.	 除草，锄草	
briefcase	[ˈbri:fkeis]	n.	 手提箱，公事皮包	
therapy	[ˈθerəpi]	n.	 治疗，物理疗法	
access	[ˈækses]	vi.	 使用；接近；存取	
shock	[ʃɔk]	v.	 （使）震动/震惊	
dedicate	[ˈdedikeit]	vt.	 奉献；献身于	
regime	[reiˈʒi:m]	n.	 政体，制度	
everyone	[ˈevriwʌn]	pron.	 （everybody）每人，人人，各人	
pint	[paɪnt]	n.	 品脱	
annual	[ˈænjuəl]	n.	 年刊；一年生植物	
almost	[ˈɔ:lməust]	adv.	 几乎，差不多	
already	[ɔ:lˈredi]	adv.	 已，已经，早已	
bottom	[ˈbɔtəm]	n.	 底（部）；基础，根基；海底，湖底，河床	
yield	[ji:ld]	n.	 产量，收获	
litter	[ˈlitə]	v.	 使杂乱，乱丢	
enemy	[ˈenimi]	n.	 敌人，仇敌，反对者；敌方，危害	
first	[fə:st]	pron.	 第一名	
lose	[lu:z]	v.	 丢失，迷路，输掉，亏本，失败，走慢，使沉湎于	
shilling	[ˈʃɪlɪŋ]	n.	 先令	
drawer	[drɔ:]	n.	 抽屉	
traitor	[ˈtreɪtə]	n.	 叛徒，卖国贼	
hunger	[ˈhʌŋɡə]	n.	 饥饿；渴望	
hitherto	[ˌhiðəˈtu:]	adv.	 到目前为止，迄今	
steak	[steik]	n.	 牛排；大块肉（或鱼）片	
testimony	[ˈtestiməni]	n.	 证据，证词；表明，说明	
crisis	[ˈkraisis]	n.	crises）危机，紧要关头	
shine	[ʃain]	n.	 光泽，光	
absence	[ˈæbsəns]	n.	 缺乏，不存在；缺席，不在	
bin	[bin]	n.	 垃圾桶；箱子；储物箱	
adverb	[ˈædvə:b]	adj.	 副词的	
wreath	[ri:θ]	n.	 花环，花圈	
kit	[kit]	n.	 成套工具，用具包，工具箱	
wall	[wɔ:l]	vt.	 筑墙围住，用墙隔开	
short	[ʃɔ:t]	n.	 短裤	
leave	[li:v]	n.	 许可；假期	
speech	[spi:tʃ]	n.	 演说，讲话；言语，语言	
erect	[iˈrekt]	adj.	 直立的，垂直的	
think	[θiŋk]	v.	 想，思索；认为，以为；想要；预料	
compete	[kəmˈpi:t]	vi.	 比赛；竞争；对抗	
pause	[pɔ:z]	v.	 中止，暂停	
repel	[riˈpel]	v.	 击退，抵制，使厌恶，使不愉快	
evaporate	[iˈvæpəreit]	v.	 蒸发，挥发；沉淀；发射；消失	
react	[riˈækt]	v.	 反应，起作用；（against）反对，起反作用	
strange	[streindʒ]	adj.	 奇怪的，生疏的；外地的；不舒服的	
relative	[ˈrelətiv]	n.	 亲戚，关系词	
respective	[risˈpektiv]	adj.	 各自的，各个的	
artist	[ˈɑ:tist]	n.	 艺术家，美术家；（某方面的）能手	
literary	[ˈlitərəri]	adj.	 文学的；精通文学的，从事写作的	
elegant	[ˈeliɡənt]	adj.	 优雅的；端庄的；雅致的	
guidance	[ˈɡaidəns]	n.	 引导，指导	
melon	[ˈmelən]	n.	 甜瓜	
per	[pə:]	prep.	 每；经，由	
arrest	[əˈrest]	vt.	 逮捕，扣留；阻止；吸引	
identify	[aiˈdentifai]	v.	 识别，鉴别；（with）把…和…看成一样	
avoid	[əˈvɔid]	vt.	 防止，避免；逃避，避开	
lion	[ˈlaiən]	n.	 狮子	
coke	[kəʊk]	n.	 焦炭；可口可乐	
through	[θru:]	adj.	 直达的	
quiz	[kwiz]	n.	 小型考试，测验，问答比赛	
platform	[ˈplætfɔ:m]	n.	 平台，台；站台，月台；政纲，党纲	
plea	[pli:]	n.	 抗辩；请求，恳求，托词，口实	
cock	[kɔk]	n.	 公鸡，雄鸡；龙头，开关	
evening	[ˈi:vniŋ]	n.	 傍晚，黄昏，晚上	
timid	[ˈtimid]	adj.	 胆怯的，怯懦的	
actual	[ˈæktʃuəl]	adj.	 实际的；现实的，真实的，目前的	
toast	[təust]	v.	 烘，烤；（向…）祝酒	
grasp	[ɡrɑ:sp]	v.	 抓住，抓紧；掌握，领会	
strip	[strip]	n.	 窄条，条纹	
allowance	[əˈlauəns]	n.	 补贴，津贴；零用钱；减价，折扣；允许	
instance	[ˈinstəns]	n.	 例子，事例，例证	
season	[ˈsi:zən]	n.	 季，季节，时节	
class	[klɑ:s]	n.	 班级，年级；种类，等级，阶级；（一节）课	
pet	[pet]	adj.	 宠爱的，表示亲昵的	
submit	[səbˈmit]	v.	 （to）使服从，屈服；（to）呈送，提交	
gymnasium	[dʒimˈneiziəm]	n.	 （gym）体育馆，健身房	
summon	[ˈsʌmən]	v.	 召唤；传讯；鼓起（勇气），振作（精神）	
thousand	[ˈθaʊzənd]	n.	）许许多多，成千上万	
overseas	[ˌəuvəˈsi:z]	adv.	 在海外	
desperate	[ˈdespərit]	adj.	 不顾一切的，铤而走险的；绝望的，危急的	
fluent	[ˈflu:ənt]	adj.	 流利的，流畅的	
couch	[kautʃ]	vt.	 表达	
contract	[kənˈtrækt]	n.	 订合同/契约；使缩小	
world	[wɜː(r)ld]	n.	 世界，地球；…界，领域；世间；全世界	
food	[fu:d]	n.	 食物，粮食，养料	
pearl	[pə:l]	n.	 珍珠	
father	[ˈfɑ:ðə]	n.	 父亲；创始人，发明者；（Father）神父	
domain	[dəuˈmein]	n.	 （活动，思想等）领域，范围；领地	
Latin	[ˈlætn]	n.	 拉丁语	
maintenance	[ˈmeintinəns]	n.	 维修，保养，维持，保持，生活费用	
tan	[tæn]	vt.	 晒黑	
hero	[ˈhiərəu]	n.	 英雄，勇士；男主角，男主人公	
forward	[ˈfɔ:wəd]	v.	 转交	
mend	[mend]	v.	 修理，缝补；改正，改进	
utmost	[ˈʌtməust]	n.	 极限，极度，最大可能	
comfort	[ˈkʌmfət]	v.	 安慰，使舒适	
cape	[keip]	n.	 海角，岬；披肩，短披风	
illness	[ˈilnis]	n.	 病，疾病	
project	[prəˈdʒekt]	n.	 投射，放映；设计，规划	
illusion	[iˈlju:ʒən]	n.	 幻想，错误的观念；错觉，幻觉，假象	
tumour	[ˈtjuːmə(r)]	n.	 （tumor）（肿）瘤，肿块	
servant	[ˈsə:vənt]	n.	 仆人	
recur	[riˈkə:]	v.	 （尤指不好的事）一再发生；重现	
zip	[zip]	v.	 （用拉链或像拉链那样）合上或打开	
myth	[miθ]	n.	 神话；虚构的理论	
gaol	[dʒeil]	vt.	 使…坐牢	
activate	[ˈæktiveit]	vt.	 启动，激活；驱动，驱使；使开始起作用	
threaten	[ˈθretən]	v.	 恐吓，威胁；有…危险，快要来临	
engagement	[inˈɡeidʒmənt]	n.	 约会，约定；婚约，订婚	
summary	[ˈsʌməri]	adj.	 概括的，简略的	
credit	[ˈkredit]	n.	 信用贷款，赊欠；名誉，名望，信誉	
away	[əˈwei]	adv.	 在远处；离开；渐渐远去；去掉	
tray	[trei]	n.	 盘，碟，托盘	
redundant	[riˈdʌndənt]	adj.	 多余的，过剩的；（食物）丰富的；被解雇的	
bless	[bles]	v.	 祝福，保佑	
tomorrow	[təˈmɔrəu]	adv.	 在明天，在明日	
saw	[sɔ:]	v.	 锯，锯开	
slit	[slit]	n.	 细长裂缝，狭长切口	
particle	[ˈpɑ:tikl]	n.	 粒子，微粒；极小量；小品词，虚词	
core	[kɔ:]	n.	 果核；中心，核心	
idiom	[ˈidiəm]	n.	 习语；成语；方言；（艺术等的）风格，特色	
division	[diˈviʒən]	n.	 分，分割；部门，科，处；除法；分界线	
allow	[əˈlau]	vt.	 允许，准许；承认；给予；（for）考虑到	
abandon	[əˈbændən]	vt.	 离弃，丢弃；遗弃，抛弃；放弃	
little	[ˈlitl]	adv.	 不多，几乎没有	
shave	[ʃeiv]	n.	 刮脸	
exhibition	[ˌeksiˈbiʃən]	n.	 展览会；陈列，展览	
casualty	[ˈkæʒjuəlti]	n.	 伤亡人员；受害人；损失的东西；急诊室	
arrive	[əˈraiv]	vi.	 到达；（时间、事件）到来，发生；达到	
crawl	[krɔ:l]	v.	 爬行，蠕动；缓慢（的）行进	
prospect	[ˈprɔspekt]	n.	 景色；前景，前途，展望	
bother	[ˈbɔðə]	n.	 烦恼，焦急	
interface	[ˈintəfeis]	v.	 （使）互相联系	
open	[ˈəupən]	v.	 开	
hobby	[ˈhɔbi]	n.	 业余爱好，嗜好，兴趣	
centimetre	[ˈsentiˌmi:tə]	n.	 （centimeter）厘米	
negligible	[ˈneɡlidʒəbl]	adj.	 可忽略不计的，微不足道的	
census	[ˈsensəs]	n.	 人口普查（调查）	
adhere	[ədˈhiə]	vi.	 （to）粘着；坚持，遵守；依附，追随	
violate	[ˈvaiəleit]	vt.	 违背；冒犯；侵犯；亵渎	
lunar	[ˈlju:nə]	adj.	 月亮的	
practice	[ˈpræktis]	n.	 练习，实践，实际，业务，惯例，习惯	
ourselves	[ˌauəˈselvz]	pron.	 [反身代词]我们自己；我们亲自	
occurrence	[əˈkʌrəns]	n.	 发生，出现；事件，事故，发生的事情	
pub	[pʌb]	n.	 （英国）小酒店；小旅馆	
sew	[səu]	v.	 缝，缝纫	
reverse	[riˈvə:s]	v.	 颠倒，倒转	
college	[ˈkɔlidʒ]	n.	 学院，高等专科学校，大学	
possession	[pəˈzeʃən]	n.	 拥有；所有权；所有物；财产	
ritual	[ˈritʃuəl]	n.	 （宗教）仪式，典礼	
ought	[ɔ:t]	v.	 应该（后应接to，再接动词原形）	
accuse	[əˈkju:z]	vi.	 指控，指责	
faculty	[ˈfækəlti]	n.	 才能；学院，系；（学院或系的）全体教学人员	
poster	[ˈpəustə]	n.	 海报，张贴的大幅广告	
summer	[ˈsʌmə]	adj.	 夏季的	
spoon	[spu:n]	n.	 匙，调羹	
lamb	[læm]	n.	 羔羊，小羊；羔羊肉	
fee	[fi:]	n.	 费（会费，学费等）；酬金	
ignore	[iɡˈnɔ:]	v.	 不理，不顾，忽视	
idiot	[ˈidiət]	n.	 白痴；极蠢的人；笨蛋	
load	[ləud]	n.	 装载（量），负荷（量）；（一）担	
actress	[ˈæktris]	n.	 女演员	
cargo	[ˈkɑ:ɡəu]	n.	 船货，货物	
concern	[kənˈsə:n]	n.	 关心；（利害）关系	
hardly	[ˈhɑ:dli]	adv.	 几乎不，简直不；仅仅	
amend	[əˈmend]	vt.	 修改，修订，改进	
divide	[diˈvaid]	v.	 分，划分，分开；分配；（by）除	
chimney	[ˈtʃimni]	n.	 烟囱	
bite	[bait]	n.	 咬；咬伤；疼痛；少许	
disrupt	[disˈrʌpt]	vt.	 使混乱，使崩溃，使分裂，使瓦解	
let	[let]	v.	 让，允许，听任；设，假设；出租，租给	
ground	[ɡraund]	n.	 地，地面，土地；场地，场所；理由，根据	
nonetheless	[ˌnʌnðəˈles]	adv.	 虽然如此，但是	
squirrel	[ˈskwirəl]	n.	 松鼠	
irony	[ˈaiərəni]	n.	 反语；冷嘲	
seal	[si:l]	v.	 封，密封	
erroneous	[iˈrəunjəs]	adj.	 错误的，不正确的	
bug	[bʌɡ]	v.	 窃听	
audio	[ˈɔːdiəʊ]	n.	 音频（响）（的）；声音（的），听觉（的）	
judgement	[ˈdʒʌdʒmənt]	n.	 审判，判决；判断（力）；看法，意见	
nothing	[ˈnʌθiŋ]	n.	 没有东西；什么也没有；无关紧要的人或事	
pharmacy	[ˈfɑ:məsi]	n.	 药房，药剂学，制药业，配药业，一批备用药品	
disgust	[disˈɡʌst]	v.	 使厌恶	
conspicuous	[kənˈspikjuəs]	adj.	 显眼的，明显的	
really	[ˈriəli]	adv.	 确实，实在，真正地，果然	
enjoy	[inˈdʒɔi]	vt.	 享受…的乐趣；欣赏；喜爱	
field	[fi:ld]	n.	 田野；运动场；（电或磁）场；领域，范围	
housing	[ˈhauziŋ]	n.	 住房，住房供给；（外、阀）壳，防护罩	
nominate	[ˈnɔmineit]	v.	 提名，任命	
profound	[prəˈfaund]	adj.	 深刻的，意义深远的；渊博的，造诣深的	
ascertain	[ˌæsəˈtein]	vt.	 确定，查明，弄清	
lean	[li:n]	adj.	 瘦的，无脂肪的	
money	[ˈmʌni]	n.	 货币，钱	
appendix	[əˈpendiks]	n.	 附录，附属物；阑尾，盲肠	
nap	[næp]	n.	 小睡，打盹	
fail	[feil]	v.	 失败，不及格；衰退，减弱	
comb	[kəum]	v.	 梳（理）	
installment	[ɪn'stɔːlmənt]	n.	 （instalment）分期付款；（连载的）一期	
foul	[faul]	n.	 犯规	
dialog	['daɪəlɒg]	n.	 （dialogue）对话，对白	
amplify	[ˈæmplifai]	vt.	 放大，增强；详述，详加解说	
illustrate	[ˈiləstreit]	v.	 举例说明，阐明；图解，加插图	
assign	[əˈsain]	vt.	 派给，分配；选定，指定（时间、地点等）	
cloak	[kləuk]	vt.	 掩盖，掩饰	
imagination	[iˌmædʒiˈneiʃən]	n.	 想象（力）；空想，幻觉；想象出来的事物	
sneeze	[sni:z]	n.	 喷嚏	
proper	[ˈprɔpə]	adj.	 适合的；合乎体统的；固有的；有礼貌的	
million	[ˈmiljən]	num.	 百万，百万个	
insect	[ˈinsekt]	n.	 昆虫	
artistic	[ɑ:ˈtistik]	adj.	 艺术（家）的，美术（家）的；善于艺术创作的	
suitable	[ˈsju:təbl]	adj.	 （for）合适的，适宜的	
strenuous	[ˈstrenjuəs]	adj.	 费力的，艰辛的；奋发的，努力的	
decay	[diˈkei]	v.	 腐朽，腐烂；衰减，衰退	
disclose	[disˈkləuz]	v.	 揭示，泄露	
along	[əˈlɔŋ]	prep.	 沿着，顺着	
sex	[seks]	n.	 性别，性	
unfold	[ʌnˈfəuld]	vi.	 呈现；显示；展示	
inland	[ˈinlənd]	adj.	 国内，内地，内陆	
bronze	[brɔnz]	n.	 青铜；青铜色，古铜色；青铜制品，铜牌	
vigorous	[ˈviɡərəs]	adj.	 朝气蓬勃的，精力旺盛的	
pale	[peil]	adj.	 苍白的，灰白的；浅的，暗淡的	
kilo	[ˈkiləu]	n.	 千克	
gentle	[ˈdʒentl]	adj.	 和蔼的，文雅的，有礼貌的	
household	[ˈhaushəuld]	adj.	 家庭（务）的，家常的	
counter	[ˈkauntə]	v.	 反对，反击	
worth	[wə:θ]	adj.	 值…的，价值…的，值得…的	
minority	[maiˈnɔriti]	n.	 少数，少数派，少数民族	
murmur	[ˈmə:mə]	v.	 小声说（话）；小声抱怨，咕哝	
found	[faund]	vt.	 建立；创立；创办；使有根据；铸造；熔制	
auxiliary	[ɔ:ɡˈziljəri]	n.	 辅助者，辅助设备	
relativity	[ˌreləˈtiviti]	n.	 相关（性）；相对论	
conceal	[kənˈsi:l]	v.	 隐藏，隐瞒，隐蔽	
arrow	[ˈærəu]	n.	 箭，矢，箭状物；箭头符号	
document	[ˈdɔkjumənt]	n.	 公文，文献	
fax	[fæks]	n.	 传真（机）	
focus	[ˈfəukəs]	v.	 （on）使聚集	
horn	[hɔ:n]	n.	 （牛羊等的）角；号，喇叭；角状物；角制品	
detect	[diˈtekt]	v.	 察觉，发觉，侦察，探测	
emigrate	[ˈemiɡreit]	v.	 （反）immigrate；（to，from）自本国移居他	
tennis	[ˈtenɪs]	n.	 网球	
prove	[pru:v]	v.	 证明，证实；检验；考验；鉴定；结果是，表明是	
remnant	[ˈremnənt]	adj.	 剩余的，残留的	
nail	[neil]	v.	 将…钉牢，钉住	
fixture	[ˈfikstʃə]	n.	 固定设备；预定日期；比赛时间；常客	
map	[mæp]	vt.	 在地图上标示出，绘制地图	
tempo	[ˈtempəu]	n.	 节奏，行进速度；（音乐的）速度	
dare	[dɛə]	v.	 敢，胆敢	
assist	[əˈsist]	vi.	 帮忙，参加	
construction	[kənˈstrʌkʃən]	n.	 建造，构造；建筑物，结构；解释	
security	[siˈkjuəriti]	n.	）证券	
historian	[hisˈtɔ:riən]	n.	 历史学家	
relate	[riˈleit]	v.	 叙述，讲述；使互相关联	
glorious	[ˈɡlɔ:riəs]	adj.	 壮丽的，辉煌的；光荣的	
newspaper	[	n.	 报纸	
clone	[kləun]	v.	 克隆	
saucer	[ˈsɔ:sə]	n.	 茶托，碟子	
wood	[wud]	n.	）森林，林地	
operational	[ˌɔpəˈreiʃənəl]	adj.	 操作的，运转的，起作用的，经营的	
rally	[ˈræli]	n.	 聚集，集会，拉力赛	
design	[diˈzain]	n.	 设计，图样	
ruby	[ˈru:bi]	n.	 红宝石	
spade	[speid]	n.	 铁锹，铲子	
postman	[ˈpəustmən]	n.	 邮递员	
tension	[ˈtenʃən]	n.	 （紧张）状态；拉（绷）紧；张力，拉力	
cow	[kau]	n.	 母牛，奶牛	
fabulous	[ˈfæbjuləs]	adj.	 极好的；极为巨大的；寓言中的，传说中的	
gracious	[ˈɡreiʃəs]	adj.	 亲切的，客气的；宽厚的，仁慈的	
restaurant	[ˈrestərənt]	n.	 餐馆，饭店	
compact	[kəmˈpækt]	v.	 使紧凑，压缩	
decimal	[ˈdesiməl]	n.	 小数	
sightseeing	[ˈsaitˌsi:ɪŋ]	n.	 观光，游览	
vertical	[ˈvə:tikəl]	n.	 垂线	
similar	[ˈsimilə]	adj.	 （to）相似的，类似的	
pin	[pin]	v.	 （up）钉住，别住	
wrap	[ræp]	n.	 披肩，围巾	
considerate	[kənˈsidərit]	adj.	 考虑周到的，体谅的	
exert	[iɡˈzə:t]	v.	 尽（力），施加（压力等），努力	
distribute	[disˈtribju:t]	v.	 分发；分配；分布；配（电）；（over）散布	
waterfall	[ˈwɔ:təˌfɔ:l]	n.	 瀑布	
barely	[ˈbɛəli]	adv.	 勉强，几乎没有；赤裸裸地，无遮蔽地	
sustain	[səˈstein]	vt.	 支撑，撑住；维持，持续，经受，忍耐	
cruel	[ˈkru:əl]	adj.	 残忍的，残酷的	
corn	[kɔ:n]	n.	 谷物，庄稼，玉米	
initiative	[iˈniʃiətiv]	n.	 第一步，创始，主动精神	
lung	[lʌŋ]	n.	 肺	
stuff	[stʌf]	v.	 填满，塞满	
significance	[siɡˈnifikəns]	n.	 意义，含义；重要性，重要的	
sovereign	[ˈsɔvrin]	n.	 君主，国王，统治者	
grin	[ɡrin]	n.	 露齿而笑，咧嘴一笑	
sentence	[ˈsentəns]	v.	 宣判，判决	
lovely	[ˈlʌvli]	adj.	 可爱的，好看的；令人愉快的，美好的	
murder	[ˈmə:də]	v.	 谋杀，凶杀	
will	[wil]	n.	 意志；决心；愿望	
skillful	[ˈskilful]	adj.	 灵巧的，娴熟的	
pioneer	[ˌpaiəˈniə]	n.	 先驱，倡导者，开拓者	
more	[mɔ:]	adv.	 更，更多	
understanding	[ˌʌndəˈstændiŋ]	adj.	 了解的，通情达理的	
overhear	[ˌəuvəˈhiə]	v.	 偶然听到，从旁听到	
treason	[ˈtri:zn]	n.	 谋反，通敌，叛国	
accommodation	[əˌkɔməˈdeiʃən]	n.	 住宿，留宿；膳宿供应	
inherit	[inˈherit]	vt.	 继承（金钱等），经遗传而得（性格、特征）	
soar	[sɔ:]	vi.	 高飞，翱翔；飞涨；高耸	
setting	[ˈsetiŋ]	n.	 安置；落山；（固定东西的）柜架底座；环境	
connection	[kəˈnekʃən]	n.	 （connexion）联系，连接；亲戚，社会关系	
scout	[skaut]	v.	 搜索，侦察	
stadium	[ˈsteidjəm]	n.	 体育场	
suicide	[ˈsjuisaid]	n.	 自杀；自杀性的行为	
between	[biˈtwi:n]	adv.	 在中间	
event	[iˈvent]	n.	 重大事件，事情	
attractive	[əˈtræktiv]	adj.	 吸引人的，引人注意的；漂亮的，迷人的	
metaphor	[ˈmetəfə]	n.	 隐喻，暗喻	
life	[laif]	n.	 生命，生存；一生，寿命；生活；生物	
diminish	[diˈminiʃ]	v.	 缩小，减少，递减	
fond	[fɒnd]	adj.	 （of）喜爱的，爱好的	
conscience	[ˈkɔnʃəns]	n.	 良心，良知	
stability	[stəˈbiliti]	n.	 稳定，安定	
weep	[wi:p]	n.	 哭泣	
sock	[sɔk]	n.	 短袜	
portion	[ˈpɔ:ʃən]	n.	 一部分，一份	
capsule	[ˈkæpsju:l]	n.	 胶囊；太空舱	
spring	[spriŋ]	v.	 跳，跳跃；发源；使裂开	
metal	[ˈmetl]	n.	 金属，金属制品	
form	[fɔ:m]	v.	 组成，构成；形成	
commend	[kəˈmend]	v.	 称赞，表扬；委托保管；推荐	
storey	[ˈstɔ:ri]	n.	 楼，层	
practitioner	[prækˈtiʃənə]	n.	 实践者，从事者；（医生或律师等）开业者	
condense	[kənˈdens]	v.	 （使）冷凝，（使）凝结；浓缩，压缩，简缩	
facilitate	[fəˈsiliteit]	v.	 使变得（更）容易；使便利；推动；帮助；促进	
Wednesday	[ˈwenzdi]	n.	 星期三	
cope	[kəup]	v.	 （with）竞争，对抗；（with）对付，妥善处理	
junk	[dʒʌŋk]	n.	 废弃物，废旧物；舢板	
employ	[imˈplɔi]	n.	 雇用；用，使用	
notion	[ˈnəuʃən]	n.	 概念，想法，意念，看法，观点	
repeatedly	[riˈpi:tidli]	adv.	 重复地，再三地	
pink	[piŋk]	adj.	 粉红色的	
gender	[ˈdʒendə]	n.	 （生理上的）性；（名词、代词等的）性	
lake	[leik]	n.	 湖泊，湖水	
anyhow	[ˈenihau]	adv.	 不管怎么说，无论如何；不论用何种方法	
job	[dʒɔb]	n.	 工作，职位；任务，职责	
tower	[ˈtauə]	v.	 高耸	
haul	[hɔ:l]	v.	 拖曳，拖运，用力拖	
projector	[prəˈdʒektə]	n.	 放映机，幻灯机，投影仪	
grip	[ɡrip]	v.	 紧握，抓紧；掌握	
push	[puʃ]	n.	 推，推力；促进，推进	
paper	[ˈpeipə]	n.	）文件；试卷；论文	
mission	[ˈmiʃən]	n.	 使命，任务；使团，代表团	
jam	[dʒæm]	v.	 （使）阻塞，（使）轧住不动	
wedge	[wedʒ]	vt.	 楔牢，楔入，挤进	
forehead	[ˈfɔrid]	n.	 前额；（任何事物的）前部	
abuse	[əˈbju:s]	n.	 滥用；恶习；弊端	
naughty	[ˈnɔ:ti]	adj.	 顽皮的，淘气的	
door	[dɔ:]	n.	 门；门口，出入口；人家；通道	
few	[fju:]	adj.	 [表肯定]有些，几个；[表否定]几乎没有的	
refuse	[ˈrefju:s]	v.	 废物，垃圾	
exile	[ˈeksail]	vt.	 流放，放逐，把…充军	
pebble	[ˈpebl]	n.	 卵石	
performance	[	n.	 履行，执行；表演，演出；性能，特性；成绩	
tug	[tʌɡ]	n.	 拖；苦干；拖船	
spine	[spain]	n.	 脊柱，脊椎；（动植物的）刺；书脊	
mate	[meit]	v.	 结伴，配对，交配	
church	[tʃə:tʃ]	n.	 教堂；教会，教派；礼拜仪式	
owl	[aul]	n.	 猫头鹰	
category	[ˈkætiɡəri]	n.	 种类，部属，类目；范畴，类型	
west	[west]	adv.	 向西	
mood	[mu:d]	n.	 心情，情绪；语气	
emit	[iˈmit]	vt.	 发出；放射；吐露；散发；发表；发行	
honest	[ˈɔnist]	adj.	 诚实的，正直的，老实的	
anticipate	[ænˈtisipeit]	vt.	 预料；期望；预先考虑；抢先；提前使用	
liberal	[ˈlibərəl]	adj.	 慷慨的，大方的；富足的；自由的，思想开放的	
expertise	[ˌekspɜːˈtiːz]	n.	 专门知识（或技能等），专长	
group	[ɡru:p]	v.	 分组	
capitalism	[ˈkæpitəlizəm]	n.	 资本主义	
shift	[ʃift]	n.	 转换，转变；（轮）班，（换）班	
spy	[spai]	v.	 当间谍，刺探；察觉，发现	
composition	[ˌkɔmpəˈziʃən]	n.	 作品，作文，乐曲；作曲；结构，组成，成分	
quote	[kwəut]	v.	 引用，援引	
admission	[ədˈmiʃən]	n.	 允许进入；承认；入场费，入场券	
crowd	[kraud]	v.	 聚集，群集；挤满，拥挤	
initial	[iˈniʃəl]	n.	 词首大写字母	
distress	[disˈtres]	v.	 使苦恼	
regulation	[ˌreɡjuˈleiʃən]	n.	 规则，规章；调节，校准；调整	
postcard	[ˈpəʊstkɑːd]	n.	 明信片	
thirsty	[ˈθə:sti]	adj.	 口渴的；（for）渴望的，热望的	
frank	[fræŋk]	adj.	 坦白的，直率的	
physician	[fiˈziʃən]	n.	 内科医生	
envelope	[ˈenvələup]	n.	 信封，信皮；封套	
fry	[frai]	v.	 油煎，油炸	
failure	[ˈfeiljə]	n.	 失败，不及格；失败者；故障，失灵；未能	
melody	[ˈmelədi]	n.	 旋律，曲调；悦耳的音乐	
congratulate	[kənˈɡrætjuleit]	v.	 （on）祝贺，向…致贺词	
hover	[ˈhɔvə]	vi.	 （鸟）盘旋，翱翔，（人）逗留，在附近徘徊	
proclaim	[prəˈkleim]	v.	 宣告，声明	
ceiling	[ˈsi:liŋ]	n.	 天花板；最高限额	
vulnerable	[ˈvʌlnərəbl]	adj.	 易受攻击的	
severe	[siˈviə]	adj.	 严厉的；剧烈的，严重的，严峻的，艰难的	
virtue	[ˈvə:tju:]	n.	 德行，美德；贞操；优点；功效，效力	
breast	[brest]	n.	 胸膛，乳房	
sheet	[ʃi:t]	n.	 被单；（一）张，（一）片，薄片；大片	
